__Name = "Français"
__DebugOnly = false
// Les deux lignes ci-dessus *DOIVENT* être les deux premières ligne du fichier !

Misc
{
    Okay = "Confirmer"
    Cancel = "Annuler"
    Apply = "Appliquer"
    Yes = "Oui"
    No = "Non"
    MenuBack = "◀ Retour"
    ScreenshotSavedFmt = "Capture d'écran sauvegardée à l'emplacement <b>{0}</b>"
    ScreenshotOpenFolder = "Ouvrir le dossier"
    DefaultShipName = "Vaisseau anonyme"
    SavedGameIncompatible = "Sauvegarde de partie incompatible avec cette version de Cosmoteer. Désolé !"
    SavedShipIncompatible = "Sauvegarde de vaisseau incompatible avec cette version de Cosmoteer. Désolé !"
    SaveShipError = "Erreur pendant la sauvegarde du vaisseau dans le fichier \"{0}\" : {1}"
    LoadShipError = "Le fichier n'est pas un vaisseau compatible. Error: {0}"
    SaveGameError = "Erreur pendant la sauvegarde de la partie dans le fichier \"{0}\": {1}"
    ShipClassIncompatible = "Classe de vaisseau incompatible."
    NoBlueprints = "Le vaisseau n'a pas de plans."
    GpuDriversOutOfDateFmt = "<bad><b>AVERTISSEMENT:</b></bad> Vos drivers graphiques datent de plus de <b>{0} mois</b> ! Les vieux drivers graphiques peuvent provoquer des plantages en jouant à Cosmoteer. "\
                             "Si vous rencontrez des plantages, mettez à jour vos drivers graphique, s'il vous plait (cet avertissement peut être désactivé dans les réglages \"Divers\")."
    LoadingUncachedAssets = "Chargement des assets du jeu pour la première fois.\nCela peut prendre plus de temps que d'habitude."
    OpenUrlConfirm = "Minimisera Cosmoteer et ouvrira une page dans votre navigateur internet."
}

TitleScreen
{
    NewGame = "Nouvelle partie"
    LoadGame = "Charger une partie"
    Multiplayer = "Multijoueur"
    Exit = "Quitter"
    News = "Actualités"
    NewsFmt = "Actualités <bad>({0})</bad>"
    Settings = "Paramètres"
    Mods = "Mods"
    ShipLibrary = "Bibliothèque de vaisseaux"
    Credits = "Générique"
    Community = "Communauté"
    Forum = "Forum"
    Discord = "Discord"
    Steam = "Steam"
    Wiki = "Wiki"
    Roadmap = "Feuille de route"
    Reddit = "Reddit"
    Facebook = "Facebook"
    Twitter = "Twitter"
    Itch = "itch.io"
    IndieDB = "Indie DB"
    Feedback = "Envoyer une remarque"
    ConfirmHideAlert = "Êtes-vous sûr de vouloir masquer cette alerte ?"
}

NewGame
{
    StartNewGame = "Nouvelle partie"
}

News
{
    TitleFmt = "Actualités ({0}/{1})"
    Previous = "◀ Précédente"
    Next = "Suivante ▶"
    Close = "Fermer"
}

LobbyScreen
{
    Host = "Héberger une partie"
    HostTip = "Créer une nouvelle partie que d'autres joueurs peuvent rejoindre. Vous pourrez modifier les réglages de la partie."
    Join = "Rejoindre une partie"
    JoinTip = "Rejoindre la partie sélectionnée, hébergée par un autre joueur."
    Online = "En ligne"
    LAN = "Réseau local (L.A.N.)"
    DirectConnect = "Connexion via I.P."
    DirectConnectTip = "Se connecter à une partie hébergée par un autre joueur en saisissant son adresse I.P. publique."
    DirectConnectMsg = "Saisissez l'adresse I.P. publique de l'ordinateur hébergeant la partie."
    ConnectingToServerFmt = "Connexion au serveur '{0}'…"
    ServerConnectionTimedOut = "La connexion au serveur a expirée."
    ServerConnectionDenied = "Connexion au serveur refusée."
    EnterPassword = "Cette partie nécessite un mot de passe : "
    Joining = "Vous rejoignez la partie…"
    TimedOut = "La requête a expirée."
    SearchingOnlineFmt = "Recherche de parties sur le serveur '{0}'…"
    SearchingLan = "Recherche de parties sur votre réseau local…"
    Incompatible = "<bad>INCOMPATIBLE</bad>"
    Full = "<bad>PLEIN</bad>"
    InProgress = "<bad>EN COURS</bad>"
    Closed = "<bad>FERMÉ</bad>"
    PlayerName = "Pseudonyme : "
    Server = "Serveur : "
    AddCustomServer = "Ajouter un serveur personnalisé"
    EditCustomServer = "Modifier ce serveur"
    RemoveCustomServer = "Supprimer ce serveur"
    ConfirmRemoveCustomServerFmt = "Êtes-vous sûr de vouloir supprimer '{0}' de la liste des serveurs personnalisés ?"
    PlayersFmt = "{0}/{1}"
    Mute = "Mettre en sourdine"
    MuteTip = "Si coché, vous ne verrez plus de messages de tchat envoyés par ce joueur."
    Ban = "Bannir de mes parties"
    BanTip = "Si coché, ce joueur ne sera plus en mesure de rejoindre une partie que vous hébergez."
    LatencyFmt = "{0} ms"
    PasswordTip = "Mot de passe requis"

    GameInfo
    {
        InProgress = "<bad>PARTIE EN COURS</bad>"
        Incompatible = "<bad>INCOMPATIBLE</bad>"
        Closed = "<bad>LA PARTIE EST CLOSE</bad>"
        Full = "<bad>LES PARTIES SONT PLEINES…</bad>"
        GameModeFmt = "<b>Mode de jeu :</b> <good>{0}</good>"
        HostFmt = "<b>Hôte :</b> {0}"
        PlayersFmt = "<b>Joueurs :</b> {0}/{1}"
        PasswordYes = "<b>Nécessite un mot de passe :</b> <bad>OUI</bad>"
        PasswordNo = "<b>Nécessite un mot de passe :</b> <bad>NON</bad>"
        HostMods = "Mods que l'hôte utilise mais pas vous : "
        YourMods = "Mods que vous utilisez mais pas l'hôte : "
        SettingFmt = "<b>{0} :</b> {1}"
        SettingYes = "OUI"
        SettingNo = "NON"
    }

    ServerJoinDenyReason
    {
        ServerNotRunning = "Le serveur n'accepte aucune connexion."
        VersionIncompatible = "Votre version de Cosmoteer n'est pas compatible avec la version du serveur.\nVous devez jouer avec une version compatible pour pouvoir vous connecter."
        IncorrectPassword = "Mot de passe incorrect."
        ServerFull = "Le serveur est complet et n'accepte aucun joueur supplémentaire."
        Banned = "Vous avez été bannis de ce serveur."
    }

    GameJoinDenyReason
    {
        GameNotRunning = "Cet hôte n'a pas de partie en cours."
        GameClosed = "L'hôte a fermé la partie afin qu'aucun autre joueur de puisse y participer."
        GameFull = "Cette partie est actuellement complète."
        VersionIncompatible = "Votre version de Cosmoteer n'est pas la même que la version de l'hôte. Tous les joueurs doivent utiliser la même version de Cosmoteer."
        DataIncompatible = "Vos données sont incompatible avec les données de l'hôte. Cela peut être causé par des mods."
        OSIncompatible = "Votre système d'exploitation (OS) est incompatible avec l'OS de l'hôte. Cela se produit généralement quand l'OS de l'hôte est en 32bits et que votre OS est en 64bits (ou l'inverse)."
        ModsIncompatible = "Vous et l'hôte utilisez des mods incompatibles."
        IncorrectPassword = "Mot de passe incorrect."
        Banned = "L'hôte vous a bannis de ses parties."
        Unknown = "Impossible de rejoindre la partie, raison inconnue."
    }

    CustomServer
    {
        Nickname = "Nom :"
        Address = "Adresse IP ou hostname :"
        Port = "Port (facultatif) :"
        Password = "Mot de passe (facultatif) :"
    }
}

GameSetupScreen
{
    Start = "LANCER LA PARTIE"
    StartTip = "Démarre la partie !"
    CantStartTip = "Tous les joueurs doivent ajouter au moins un vaisseau à leur flotte puis cliquer sur \"PRÊT\" avant que la partie ne puisse commencer."
    Ready = "PRÊT"
    ReadyTip = "Faites savoir aux autres joueurs que vous êtes prêt à démarrer la partie ! Elle ne pourra débuter tant que les autres joueurs ne sont pas prêt."
    CantReadyTip = "Vous devez ajouter au moins un vaisseau à votre flotte."
    CancelReady = "PAS PRÊT"
    CancelReadyTip = "Empêche la partie de démarrer tant que vous ne cliquez pas de nouveau sur \"PRÊT\"."
    GameClosed = "La partie est <bad>FERMÉE</bad>.\n<s12>Aucun autre joueur ne pourra la rejoindre.</s12>"
    GameOpen = "La partie est <good>OUVERTE</good>.\n<s12>Les autres joueurs peuvent la rejoindre.</s12>"
    CancelGame = "◀ Annuler la partie"
    LeaveGame = "◀ Quitter la partie"
    ChangeGameName = "Modifier le nom de la partie"
    ChangeGameNameMsg = "Entrez un nouveau nom pour cette partie :"
    TeamFmt = "Équipe {0}"
    Players = "Joueurs"
    Observers = "Observateurs"
    JoinTeam = "Rejoindre"
    PlayerJoined = "{0} à rejoint la partie."
    PlayerLeft = "{0} a quitté la partie."
    KickPlayer = "Dégager temporairement le joueur"
    BanPlayer = "Dégager & bannir à jamais"
    RemoveAIPlayer = "Supprimer l'I.A."
    BanConfirm = "Êtes-vous sûr de vouloir dégager ce joueur de la partie et le bannir de toutes vos futures parties ?"
    RenamePlayer = "Modifier le pseudonyme"
    RenamePlayerMsg = "Entrez un nouveau pseudonyme pour vous-même :"
    PlayerIsHost = "<good>HÔTE</good>"
    PlayerIsAI = "<good>JOUEUR I.A.</good>"
    PlayerIsReady = "<good>PRÊT</good>"
    PlayerIsNotReady = "<bad>PAS PRÊT</bad>"
    PlayerYouFmt = "{0} <color r='255' g='255' b='255' a='127'>(vous)</color>"
    AddShip = "+"
    AddShipTip = "Ajouter un vaisseau à votre flotte."
    RemoveShip = "X"
    RemoveShipTip = "Supprimer ce vaisseau de votre flotte."
    InvalidShip = "Ce vaisseau a un design invalide ou est illégal selon les paramètres de la partie actuelle."
    Password = "Mot de passe"
    PasswordTip = "Si non vide, le mot de passe que les autres joueurs devront saisir pour rejoindre la partie."
    GameMode = "Mode de jeu"
    GameModeTip = "Le type de partie multijoueur qui sera joué."
    FundsRemainingFmt = "<money>{0:n0}₡</money>"
    InsFundsRemainingFmt = "<ins_money>{0:n0}₡</ins_money>"
    FundsRemainingTip = "Le montant de crédits (₡) restants que ce joueur peut dépenser."
    PlayersFmt = "{0}/{1} joueurs"
    PortForwardingSuccessFmt = "Configuration réussie pour la redirection du port UDP {0}. Les joueurs en dehors de votre réseau local doivent pouvoir rejoindre votre partie "\
                               "en utilisant votre adresse IP publique."
    PortForwardingFailureFmt = "Impossibilité de configurer automatiquement la redirection du port UDP {0}. Vous devez configurer manuellement la redirection de port "\
                               "pour que les joueurs hors de votre réseau local puissent rejoindre votre partie."
    PublicIPFmt = "Votre adresse IP publique est {0}. Elle a été copiée automatiquement dans votre presse-papier (attention: partager votre adresse IP publique avec des inconnus peut potentiellement vous exposer à des hacks, des attaques par \"déni de service\", et d'autres risques)."
    GameChat = "Tchat de la partie"
    LobbyChat = "Tchat du lobby"
    AddAI = "Ajouter un joueur I.A."
    AdvancedOptions = "Options de jeu avancées"
    ModsEnabledMsg = "Vous avez un ou plusieurs mods activés. Les autres joueurs pourront rejoindre votre partie uniquement s'ils ont exactement les mêmes mods activés."

    HostDisconnectReason
    {
        Canceled = "L'hôte a annulé la partie."
        Kicked = "L'hôte vous a dégagé temporairement de la partie."
        ConnectionLost = "Connexion perdue avec l'hôte."
    }
}

GameLaunchFlow
{
    HostInitializing = "Lancement de la partie…\n(Initialisation)"
    HostSending = "Lancement de la partie…\n(Envoi des données)"
    HostWaiting = "Lancement de la partie…\n(En attente des autres joueurs)"
    HostStarting = "Démarrage de la partie !"
    ClientReceiving = "Lancement de la partie…\n(Récéption des données)"
    ClientInitializing = &HostInitializing
    ClientWaiting = &HostWaiting
    ClientStarting = &HostStarting
}

GameResyncFlow
{
    HostSaving = "Partie désynchronisée, resynchonisation…\n(Sauvegarde de l'état de la partie)"
    HostSending = "Partie désynchronisée, resynchonisation…\n(Envoi de l'état de la partie)"
    HostInitializing = "Partie désynchronisée, resynchonisation…\n(Initialisation)"
    HostWaiting = "Partie désynchronisée, resynchonisation…\n(En attente des autres joueurs)"
    HostResuming = "Reprise de la partie !"
    ClientReceiving = "Partie désynchronisée, resynchonisation…\n(Récéption de l'état de la partie)"
    ClientInitializing = &HostInitializing
    ClientWaiting = &HostWaiting
    ClientResuming = &HostResuming
}

ChatBox
{
    Send = "Envoyez"
    ToggleTeam = "Équipe"
    ToggleTeamTip = "Si coché, vos messages ne seront envoyés qu'au membre de votre équipe.\n\nRaccourci : <btn id='Multiplayer.ToggleTeamChat'/>"
    SendingTooFast = "Oulà, doucement malheureux ! Tu envois tes messages bien trop rapidement !"
    ChatFmt = "<good>{0} : </good>{1}"
    TeamChatFmt = "<good>{0} : </good><bad>(ÉQUIPE)</bad> {1}"
}

Multiplayer
{
    DefaultPlayerName = "Joueur anonyme"
    DefaultGameName = "Partie sans nom"
    DefaultGameNameFmt = "Partie de {0}"
    ShuttingDown = "Veuillez patienter…"
    WinnerFmt = "{0} à gagné !"
    TieGame = "MATCH NUL"
    TimeRemainingTip = "Temps restant avant que la partie ne se termine et que l'équipe avec le plus de force restantes soit déclarée vainqueur."
    TeamStrengthTipFmt = "Force restante du joueur ou de l'équipe. Ils seront vaincus une fois la barre vide."
    TeamFmt = "Équipe {0}"
    PlayerLeft = "{0} a quitté la partie."
    NextGameCountdownFmt = "Prochaine partie dans {0} secondes…"
    AddressAlreadyInUseFmt = "Un autre programme utilise déjà le port UDP {0} et doit être fermé avant que vous puissiez jouer en multijoueur."
    ErrorInitializingFmt = "Erreur lors de l'initialisation du multi : {0}"
    Forfeit = "Déclarer forfait"
    ForfeitConfirm = "Étes-vous sûr de vouloir déclarer forfait ?"

    GameEndReason
    {
        Deliberate = "L'hôte a mis fin à la partie."
        ConnectionLost = "Connexion perdue"
        ServerDisconnected = "Connexion perdue au serveur de la partie."
    }
}

LoadSaveGame
{
    TitleLoad = "Charger une partie"
    TitleSave = "Sauvegarder une partie"
    OkayLoad = "Charger la partie"
    OkaySave = "Sauvegarder la partie"
    OpenFolder = "Ouvrir un dossier"
    Delete = "Supprimer"
    ConfirmDeleteFmt = "Étes-vous sûr de vouloir supprimer '{0}' ? Cela mettra le fichier à la corbeille."
    ConfirmOverwrite = "Écraser la sauvegarde déjà existante ?"

    Manual = "Sauvegardes Manuelles"
    Auto = "Sauvegardes Automatiques"
    Quick = "Sauvegardes Rapides"
}

ShipLibrary
{
    TitleLoad = "Charger un vaisseau"
    TitleSave = "Sauvegarder le vaisseau"
    TitleBuy = "Acheter un vaisseau"
    TitlePlaytest = "Bibliothèque de vaisseaux"
    TitleOrganize = "Bibliothèque de vaisseaux"

    SmallIcons = "Petites icônes"
    LargeIcons = "Grandes icônes"

    OkayLoad = "Charger le vaisseau"
    OkaySave = "Sauvegarder le vaisseau"
    OkayBuy = "Acheter le vaisseau"
    OkayPlaytest = "Tester"
    CrewCountFmt = "{0} membres d'équipage"
    ConfirmOverwrite = "Écraser le vaisseau existant ?"

    RenameShip = "Renommer"
    RenameShipMsg = "Entrez un nouveau nom pour ce vaisseau :"
    DeleteShip = "Supprimer"
    ConfirmDeleteShipFmt = "Êtes-vous sûr de vouloir supprimer '{0}' ?"

    NewFolder = "Nouveau dossier"
    NewFolderMsg = "Entrez un nom pour le dossier:"
    RenameFolder = "Renommer le dossier"
    RenameFolderMsg = "Entrez un nouveau nom pour le dossier:"
    DeleteFolder = "Supprimer le dossier"
    DeleteFolderFmt = "Êtes-vous sûr de vouloir supprimer le dossier <b>{0}</b>?"
    OpenFolder = "Ouvrir le dossier"

    Organize = "Organiser"

    ImportError = "Erreur lors du chargement de ce vaisseau: {0}"
    ImportCustomName = "Veuillez entrez un nom pour ce vaisseau :"

    SortTip = "Détermine l'ordre dans lequel les vaisseaux sont triés."
    SearchTip = "Filtrez les vaisseaux ci-dessous pour montrer seulement ceux dont le nom correspond au texte saisi ici."

    SortMode
    {
        Name = "Trier par : Nom"
        NameTip = "Trie les vaisseaux par ordre alphabétique des noms."
        CostLow = "Trier par : Prix (Ascendant)"
        CostLowTip = "Trie les vaisseaux du moins cher au plus cher."
        CostHigh = "Trier par : Prix (Descendant)"
        CostHighTip = "Trie les vaisseaux du plus cher au moins cher."
        CrewLeast = "Trier par : Membres d'équipage (Ascendant)"
        CrewLeastTip = "Trie les vaisseaux du moins peuplé au plus peuplé."
        CrewMost = "Trier par: Membres d'équipage (Descendant)"
        CrewMostTip = "Trie les vaisseaux du plus peuplé au moins peuplé."
        Newest = "Trier par : Nouveauté"
        NewestTip = "Trie les vaisseaux du plus récemment modifié au plus anciennement modifié."
        Oldest = "Trier par : Ancienneté"
        OldestTip = "Trie les vaisseaux du plus anciennement modifié au plus récemment modifié."
    }
}

Inputs
{
    PressKeyOrClick = "Appuyez sur la touche que vous souhaitez utiliser ou cliquez ici :"
    Clear = "Effacer"
    Default = "Par Défaut"
    Defaults = "Par Défaut"
    None = "Aucun"

    General
    {
        Name = "Général"
        UIClick = "Clic principal"
        UIAltClick = "Clic alternatif"
        UIFocusClick = "Clic focalisant"
        Confirm = "Ok / Accepter / Confirmer"
        Cancel = "Annuler / Retour / Menu"
        SuppressConfirmation = "Confirmer la suppression"
        ToggleFullscreen = "Alterner plein écran"
        TakeScreenshot = "Prendre une capture d'écran"
        SubmitFeedback = "Envoyer une remarque"
        EmulateRightClick = "Simuler un clic droit"
        RestartApp = "Redémarrer le jeu"
    }

    Game
    {
        Name = "Jeu"
        Move = "Déplacer / Suivre"
        ForceMove = "Forcer le déplacement"
        Rotate = "Pivoter"
        Strafe = "Translater"
        Attack = "Attaquer"
        Halt = "Stopper"
        ToggleAutoFire = "Basculer le tir automatique (auto-fire)"
        Selection = "Sélectionner un vaisseau/module" // `part` traduit par module plutôt que par morceau ou partie
        SelectParts = "Sélectionner un module"
        AppendSelection = "Ajouter une sélection"
        ShowCommandWidgets = "Afficher les commandes"
        ShipRelativeAttackAngle = "Utiliser l'angle relatif au vaisseau" // Pas sûr de la traduction
        WorldRelativeFollowAngle = "Utiliser l'angle relatif à la grille" // Pas sûr de la traduction
        Command = "Contrôler le vaisseau/module"
        UseTool = "Utiliser l'outil"
        CancelTool = "Annuler l'outil"
        TargetWeapon = "Viser (armes)"  // Une meilleur traduction serait possible
        CancelWeaponTargets = "Annuler la visée (armes)"
        ToggleMap = "Basculer la carte de la Galaxie"
        DoFtlJump = "Engager le saut supraluminique" // FTL => supraluminique plutôt que hyperpropulsion
        CancelFtlJump = "Annuler le saut supraluminique"
        ToggleUI = "Basculer l'interface utilisateur"
        Save = "Sauvegarder la partie"
        Load = "Charger la partie"
        QuickSave = "Sauvegarde rapide"
        QuickLoad = "Chargement rapide"
        PauseToggle = "Basculer la pause"
        IncreaseSpeed = "Augment la vitesse"
        DecreaseSpeed = "Diminuer la vitesse"
        SelectAllShips = "Sélectionner tous les vaisseaux"
        SelectAllParts = "Sélectionner tous les modules"
        Chat = "Tchat"
    }

    PartTriggers
    {
        detonate = "Mise à feu des explosifs"
    }

    PartToggles
    {
        on_off = "Basculer l'alimentation du module"
        fire_mode = "Basculer le mode de tir"
        fire_alternating = "Basculer le feu en alternance" // Je ne comprends pas le terme d'origine
        thruster_boost = "Basculer la poussée des réacteurs" // Pas sûr de la traduction
    }

    View
    {
        Name = "Voir les contrôles"
        PanLeft = "Déplacement vers la gauche"
        PanRight = "Déplacement vers la droite"
        PanUp = "Déplacement vers le haut"
        PanDown = "Déplacement vers le bas"
        DragFocus = "Déplacer/Centrer la vue"
        ZoomIn = "Zoom avant"
        ZoomOut = "Zoom arrière"
        RotateRight = "Pivoter vers la droite"
        RotateLeft = "Pivoter vers la gauche"
        ResetRotation = "Réinitialiser la rotation"
        FocusCursorMode = "Mode vue centrée sur curseur"
        FocusSelected = "Centrer sur le vaisseau/module sélectionné"
        RotationFocusSelected = "Centrer et verrouiller la rotation"
        FocusTargets = "Centrer sur l'ennemi ciblé"
        RotationFocusTargets = "Centrer l'ennemi et verrouiller la rotation"
        FocusMidpoint = "Centrer sur le point médian sélection/cible"
        ToggleInteriors = "Basculer l'affichage de l'intérieur des vaisseaux"
        ViewMinimap = "Voir la mini-carte"
    }

    Multiplayer
    {
        Name = "Multijoueur"
        SendChat = "Envoyer un message sur le tchat"
        ToggleTeamChat = "Basculer le tchat d'équipe"
    }

    Design
    {
        Name = "Concepteur de vaisseau"
        BuildOpen = "Ouvrir le menu de construction"
        BuildClose = "Fermer le menu de construction"
        ToggleBlueprints = "Basculer les plans"
        PaintOpenClose = "Basculer le menu de peinture"
        Construct = "Appliquer les modifications"
        EraseTool = "Outil de suppression"
        GrabTool = "Outil de déplacement"
        SelectionTool = "Outil de sélection"
        ContiguousSelectionMode = "Mode \"baguette magique\" pour la sélection contigue"
        ToggleMirrorMode = "Basculer le mode miroir"
        SelectAll = "Sélectionner tous les modules/vignettes" // J'ai laissé `decals` => vignette
        Delete = "Supprimer tous les modules/vignettes"
        DeleteDoors = "Supprimer les portes"
        NoAutoDoors = "Ne pas ajouter de portes automatiquement"
        FillAllDoors = "Remplissage de portes" // traduction boiteuse
        CopySelected = "Copier la sélection"
        CutSelected = "Couper la sélection"
        Paste = "Coller la sélection"
        EraseCursorMode = "Mode de suppression"
        RestrictShapeMode = "Restreindre le mode Forme" // mode Forme me semble mauvais comme traduction
        AppendShapeMode = "Ajouter un mode Forme"
        ImportPng = "Importer une image PNG"
        RotateLeft = "Pivoter vers la gauche"
        RotateRight = "Pivoter vers la droite"
        FlipX = "Retourner horizontalement."
        FlipY = "Retourner verticalement."
        Undo = "Annuler"
        Redo = "Rétablir"
    }

    Brushes
    {
        Name = "Concepteur de vaisseau (Brosses)"
    }

    Parts
    {
        Name = "Concepteur de vaisseau (Modules)"
    }

    Repair
    {
        Name = "Réparations"
        OpenClose = "Basculer le menu des réparations"
        RepairAll = "Tout réparer"
        SuppressRepair = "Ne pas réparer (construire à la place)"
    }

    Crew
    {
        Name = "Équipage"
        OpenClose = "Basculer le menu d'équipage"
        FiveAtATime = "Recruter/Virer 5 à la fois"
    }

    CreativeMode
    {
        Name = "Mode créatif"
        DeleteShip = "Supprimer les vaisseaux sélectionnés"
        MoveShip = "Déplacer les vaisseaux sélectionnées à destination"
        RandomizeAsteroid = "Astéroïdes aléatoires"
        PlayAsAllPlayers = "Incarner : tous les joueurs"
        PlayAsFmt = "Incarner : joueur {0}"
        ShipLibrary = "Bibliothèque de vaisseaux"
        SpawnNotReady = "Créer sans munitions/énergie"
        AutoBattleCamera = "Basculer la caméra de bataille automatique"
    }

    Formations
    {
        Name = "Formations"
        MakeFormationFmt = "Utiliser la formation {0}"
    }

    ControlGroups
    {
        Name = "Contrôle des groupes"
        SelectShipGroupFmt = "Sélectionner le groupe de vaisseaux {0}"
        CreateShipGroupFmt = "Créer le groupe de vaisseaux {0}"
        SelectPartGroupFmt = "Sélectionner le groupe de modules {0}"
        CreatePartGroupFmt = "Créer le groupe de modules {0}"
    }

    MouseButtonNames
    {
        Left = "Clic gauche"
        Middle = "Clic milieu"
        Right = "Clic droit"
        Button4 = "Bouton souris 4"
        Button5 = "Bouton souris 5"
    }

    KeyNames
    {
        D0 = "0"
        D1 = "1"
        D2 = "2"
        D3 = "3"
        D4 = "4"
        D5 = "5"
        D6 = "6"
        D7 = "7"
        D8 = "8"
        D9 = "9"
        A = "A"
        B = "B"
        C = "C"
        D = "D"
        E = "E"
        F = "F"
        G = "G"
        H = "H"
        I = "I"
        J = "J"
        K = "K"
        L = "L"
        M = "M"
        N = "N"
        O = "O"
        P = "P"
        Q = "Q"
        R = "R"
        S = "S"
        T = "T"
        U = "U"
        V = "V"
        W = "W"
        X = "X"
        Y = "Y"
        Z = "Z"
        Quote = "Guillemet"
        Backspace = "Retour"
        BackslashPipe = "Barre oblique"
        CapsLock = "Verr.Maj"
        Colon = "Colon"
        CommaLesser = "Comma"
        Delete = "Effacer";
        DownArrow = "Flèche du bas"
        End = "Fin"
        PlusEquals = "Plus"
        Escape = "Escape"
        F1 = "F1"
        F2 = "F2"
        F3 = "F3"
        F4 = "F4"
        F5 = "F5"
        F6 = "F6"
        F7 = "F7"
        F8 = "F8"
        F9 = "F9"
        F10 = "F10"
        F11 = "F11"
        F12 = "F12"
        F13 = "F13"
        F14 = "F14"
        F15 = "F15"
        TildeBacktick = "Tilde"
        Home = "Home"
        Insert = "Insert"
        LeftBracket = "Accolade ouvrante"
        Control = "Ctrl"
        LeftArrow = "Flèche de gauche"
        Alt = "Alt"
        Shift = "Shift"
        MinusUnderscore = "Minus"
        NumLock = "Num Lock"
        NumPad0 = "Num Pad 0"
        NumPad1 = "Num Pad 1"
        NumPad2 = "Num Pad 2"
        NumPad3 = "Num Pad 3"
        NumPad4 = "Num Pad 4"
        NumPad5 = "Num Pad 5"
        NumPad6 = "Num Pad 6"
        NumPad7 = "Num Pad 7"
        NumPad8 = "Num Pad 8"
        NumPad9 = "Num Pad 9"
        NumPadMinus = "Num Pad Minus"
        NumPadPeriod = "Num Pad Dot"
        NumPadPlus = "Num Pad Plus"
        NumPadSlash = "Num Pad Slash"
        NumPadStar = "Num Pad Star"
        PageDown = "Page Down"
        PageUp = "Page Up"
        Pause = "Pause"
        PeriodGreater = "Period"
        RightBracket = "Accolade fermante"
        Enter = "Entrer"
        RightArrow = "Flèche de droite"
        ScrollLock = "Scroll Lock"
        SlashQuestion = "Slash"
        Space = "Espace"
        PrintScreen = "Print Screen"
        Tab = "Tab"
        UpArrow = "Flèche du haut"
        Command = "Commande"
        Apps = "Apps"
        PlatformCmdCtrl = "<PlatformCmdCtrl/>"
    }
}

Settings
{   // Les valeurs des TabName ont été volontairement tronqués parce qu'il n'y a pas beaucoup d'espaces de disponible
    RestartRequired = "Un des réglage ayant été modifié ne peut prendre effet qu'au redémarrage du jeu."
    RestartNow = "Redémarrer maintenant"
    RestartLater = "Redémarrer plus tard"

    Graphics
    {
        TabName = "Vidéo"

        WindowMode = "Type de fenêtre"
        WindowModeTip = "Le style de la fenêtre utilisée pour afficher le jeu."
        ExclusiveFullScreen = "Plein écran exclusif"
        ExclusiveFullScreenTip = "Le jeu utilisera tout l'écran et vous permettra de choisir la résolution d'affichage. "\
                                 "Ce mode peut être nécessaire pour utiliser des fonctionnalités avancées du GPU comme G-SYNC et FreeSync."
        ResizableWindow = "Fenêtre réajustable" // Le terme "réajustable" d'origine est plus joli et juste que "redimensionnable"
        ResizableWindowTip = "Le jeu tournera dans une fenêtre sur votre bureau. Vous pourrez bouger et redimensionner la fenêtre librement."
        BorderlessFullScreen = "Plein écran sans bordures"
        BorderlessFullScreenTip = "Le jeu va utiliser tout votre écran et s'adapter à la résolution de votre bureau. "\
                                  "Utilisez ce mode si le plein écran cause des problèmes ou si vous voulez être capable de changer d'application rapidement."

        Monitor = "Écran"
        MonitorTip = "Le moniteur sur lequel le jeu sera affiché en mode Plein écran ou Plein écran sans bordures."

        Resolution = "Résolution"
        ResolutionTip = "Résolution du jeu en mode Plein écran."
        ResolutionFmt = "{0} x {1}"

        RefreshRate = "Fréquence de rafraîchissement"
        RefreshRateTip = "Le nombre d'images que le moniteur affichera chaque seconde."
        RefreshRateFmt = "{0} hz"

        VSync = "Synchronisation verticale"
        VSyncTip = "Synchronise le jeu avec la fréquence de rafraîchissement de votre écran, ce qui élimine l'effet de déchirure mais augmente la latence d'entrée."
        VSyncOff = "Désactivée"
        VSyncOffTip = "Le jeu ne va pas être synchronisé avec la fréquence de rafraîchissement de votre écran. Il va tourner avec le maximum de fps possible et le minimum de latence d'entrée."
        VSyncOn = "Activée"
        VSyncOnTip = "Le jeu sera synchronisé avec la fréquence de rafraichissement de votre écran. "\
                     "Ceci va éliminer l'effet de déchirure mais va limiter votre fréquence d'affichage à celle de votre écran et peut augmenter la latence d'entrée."
        VSyncTriBuf = "Activée (Triple-Buffered)"
        VSyncTriBufTip = "Cette variante de la synchronisation verticale peut améliorer votre fréquence d'affichage mais peut aussi augmenter la latence d'entrée."

        DpiScaling = "Mise à l'échelle PPP"
        DpiScalingTip = "Réglage de la taille de l'interface utilisateur. Augmenter cette valeur à plus de 100% peut rendre le jeu plus agréable à jouer à haute résolution."
        DpiScaleDisabledTip = "La taille de la fenêtre ou la résolution écran n'est pas suffisament grande pour supporter cette mise à l'échelle PPI."
        Dpi100 = "100%"
        Dpi150 = "150%"
        Dpi200 = "200%"

        LimitFps = "Limiter le taux rafraîchissement"
        LimitFpsTip = "Si cette option est cochée, le jeu ne fonctionnera pas plus rapidement qu'un taux de rafraîchissement particulier."
        LimitFpsNumber = "Images par seconde"
        LimitFpsNumberTip = "Indique le nombre maximum d'images à afficher par seconde."

        AnimateBackgrounds = "Arrière-plan animé"
        AnimateBackgroundsTip = "Si activé, les arrière-plans du jeu seront animés. Désactiver cette option peut améliorer considérablement les performances."

        FancyParticles = "Particules Fantaisie"
        FancyParticlesTip = "Si activé, des effets de particules supplémentaires seront affichés. Désactiver cette option peut améliorer les performances."

        UncompressedTextures = "Utiliser des textures non compressées"
        UncompressedTexturesTip = "Si activé, les textures ne seront pas compressées. L'activation de cette option améliore très légèrement la qualité visuelle et augmente considérablement l'utilisation de RAM/VRAM. "\
                                  "La modification de cette option nécessite le redémarrage du jeu."

        ScreenShake = "Tremblement d'écran"
        ScreenShakeTip = "Si coché, certains événements dans le jeu tels que des explosions provoqueront un tremblement de l'écran."
    }

    Audio
    {
        TabName = "Audio"

        MasterVol = "Vol. Maître"
        MasterVolTip = "Contrôle le volume général de tous les sons du jeu et de la musique."

        EffectsVol = "Vol. Effets"
        EffectsVolTip = "Contrôle le volume de tous les effets sonores."

        InterfaceVol = "Vol. Interface"
        InterfaceVolTip = "Contrôle le volume des sons de l'interface."
    }

    Gameplay
    {
        TabName = "Gameplay"

        AutoFtlJump = "Enclencher automatiquement la propulsion supraluminique"
        AutoFtlJumpTip = "Si cette option est cochée, la propulsion supraluminique sera enclenchée automatiquement dès que tous les vaisseaux sont prêts à sauter."

        OnShipIndicators = "Afficher les indicateurs d'état du vaisseau"
        OnShipIndicatorsTip = "Si cette option est cochée, affiche des indicateurs lorsqu'il n'y a plus de membres d'équipage, de munitions ou d'énergie."

        OffScreenBlips = "Afficher l'écho radar pour les vaisseaux hors-écran"
        OffScreenBlipsTip = "Si coché, des échos radars colorés seront affichés sur les bords de l'écran pour afficher la position des vaisseaux."

        ZoomedOutBlips = "Afficher l'écho radar quand dézoomer"
        ZoomedOutBlipsTip = "Si coché, des échos radars colorés seront affichés pour les petits vaisseaux lors du dézoom."

        PartToolTips = "Afficher les bulles d'aide des modules"
        PartToolTipsTip = "Si cette option est cochée, les informations s'affichent après avoir laissé brièvement le curseur de la souris sur un module installé sur un vaisseau."

        AllowShipDeselection = "Autoriser la désélection de vaisseau"
        AllowShipDeselectionTip = "Si cette option est cochée, un clic gauche sur un endroit vide désélectionnera tout vaisseau actuellement sélectionné."

        ShowAdvancedCommands = "Affichage des contrôles avancés pour les vaisseaux"
        ShowAdvancedCommandsTip = "Si coché, les contrôles avancés seront affichés dans l'interface utilisateur. "\
                                  "Et même si ce n'est pas coché, les raccourcis claviers seront tout de même utilisable."

        CtrlSelectsParts = "Forcer <btn id='Game.SelectParts' xml='false'/> pour sélectionner des modules"
        CtrlSelectsPartsTip = "Si cette option est cochée, la touche <btn id='Game.SelectParts'/> doit être maintenue en cliquant sur des modules pour pouvoir les sélectionner."
        CtrlSelectsPartsDisabledTip = "Ce paramètre ne peut être changer jusqu'à la complétion du tutoriel \"Micromanager votre vaisseau\", ou que les tutoriels soient désactivés."

        AlwaysShowCommandWidgets = "Toujours afficher les poignées de commandes"
        AlwaysShowCommandWidgetsTip = "Si coché, vous ne devrez pas maintenir la touche <btn id='Game.AppendSelection'/> pour afficher les poignées de commandes du vaisseau."

        PreferShipRelativeAttackAngle = "Préférer l'angle d'attaque relatif au vaisseau"
        PreferShipRelativeAttackAngleTip = "Si coché, cliquer droit et glisser sur un vaisseau ennemi utilisera un angle d'attaque relatif au vaisseau ennemi au lieu de l'angle de la grille d'arrière-plan. Maintenez <btn id='Game.ShipRelativeAttackAngle'/> pour utiliser l'autre mode."

        PreferWorldRelativeFollowAngle = "Préférer les angles d'attaque relatifs à la grille"
        PreferWorldRelativeFollowAngleTip = "Si coché, cliquer droit et glisser sur un vaisseau ennemi utilisera un angle d'attaque relatif à la grille en arrière-plan plutôt qu'au vaisseau ennemi. Maintenez <btn id='Game.WorldRelativeAttackAngle'/> pour utiliser l'autre mode."

        AdHocFormations = "Formations automatiques de vaisseaux"
        AdHocFormationsTip = "Si coché, les vaisseaux seront automatiquement regroupés dans une formation ad hoc lorsque vous donnez un ordre à plusieurs vaisseaux à la fois."

        EnableCollisionAvoidance = "Détection de collision lors d'un clic droit"
        EnableCollisionAvoidanceTip = "Si coché, cliquer droit pour déplacer le vaisseau l'obligera à manoeuvrer pour tenter éviter des collisions avec d'autres vaisseaux. "\
                                      "Vous pouvez utiliser les commandes \"Déplacement\" et \"Déplacement forcé\" pour utiliser ou non explicitement la détection de collision."

        BreakFormationToAttack = "Biser la formation pour attaquer"
        BreakFormationToAttackTip = "Si coché, la flotte brisera automatiquement la formation lors de l'entrée de la zone d'attaque de l'ennemi."
    }

    Camera
        {
        TabName = "Caméra"

        EdgePan = "Translater"
        EdgePanTip = "Définit si la caméra peut être déplacée en déplaçant le curseur de la souris contre le bord de l'écran."
        EdgePanNone = "Désactivé"
        EdgePanNoneTip = "La caméra ne se déplace pas lorsque le curseur de la souris rencontre le bord de l'écran. Il est toujours possible d'utiliser les touches fléchées ou le bouton central de la souris."
        EdgePanAnalog = "Analogique"
        EdgePanAnalogTip = "Lorsque vous déplacez le curseur de la souris contre le bord de l'écran, la vue se déplacera dans la direction exacte tirée du centre de l'écran vers le curseur de la souris."
        EdgePanEightWay = "Huit directions"
        EdgePanEightWayTip = "Quand vous bougez le curseur contre les bords de l'écran, la caméra va se déplacer uniquement dans une des 8 directions possibles. "\
                             "La direction dépend de quel bord ou coin votre curseur touche."

        EdgePanSpeed = "Vitesse de translation"
        EdgePanSpeedTip = "Contrôle la vitesse de déplacement lorsque le curseur de la souris est contre le bord de l'écran."

        KeyPanSpeed = "Vitesse de déplacement clavier"
        KeyPanSpeedTip = "Contrôle la vitesse de déplacement lorsque les touches flèchées sont utilisées."

        KeyZoomSpeed = "Vitesse du zoom clavier"
        KeyZoomSpeedTip = "Contrôle la vitesse à laquelle la vue va zoomer en avant et en arrière lorsque vous utilisez les touches +/-."

        KeyRotSpeed = "Vitesse de rotation clavier"
        KeyRotSpeedTip = "Contrôle la vitesse de rotation lorsque vous utilisez les touches [ et ]."

        EnableMouseWheelZoom = "Zoom Molette"
        EnableMouseWheelZoomTip = "Si cette option est cochée, vous pourrez zoomer en avant et en arrière en utilisant la molette de la souris."

        WheelZoomSpeed = "Vitesse du zoom molette"
        WheelZoomSpeedTip = "Contrôle la vitesse à laquelle la vue va zoomer en avant et en arrière en utilisant la molette de la souris."

        InvertWheelZoom = "Inverser zoom molette"
        InvertWheelZoomTip = "Si cette option est cochée, la direction du zoom à l'aide de la molette de la souris sera inversée."

        WheelZoomAtCursor = "Zoom sur le curseur (molette)"
        WheelZoomAtCursorTip = "Si cette option est cochée, lorsque vous effectuez un zoom à l'aide de la molette, l'écran zoomera sur le curseur. "\
                               "Si cette option n'est pas cochée, lorsque vous effectuez un zoom à l'aide de la molette, l'écran zoomera en son centre."

        StickyFocus = "Centrage permanent des vaisseaux"
        StickyFocusTip = "Lorsque vous mettez votre vue sur un vaisseau, la vue va se \"coller\" au vaisseau. "\
                         "La vue se \"décollera\" une fois que le centre de la vue aura bougé en dehors du cercle du vaisseau."

        ShowMidpointFocusWidget = "Montre le point médian pour le focus (l'icône d'œil)"
        ShowMidpointFocusWidgetTip = "Si coché, une icône d'œil apparaîtra entre votre vaisseau et votre cible."\
                                     "Cliquer sur celui-ci centrera la caméra sur le point médian entre les deux vaisseaux."

        MiniviewLbl = "Incrustation d'image (PIP)"

        MiniviewCombatModeLbl = "En Combat"
        MiniviewCombatModeLblTip = "Choisissez si et quand l'incrustation d'image s'affiche pendant le combat."
        MiniviewNonCombatModeLbl = "Hors Combat"
        MiniviewNonCombatModeLblTip = "Choisissez si et quand l'incrustation d'image s'affiche hors combat."
        MiniviewLockRotation = "Verrouiller la rotation du vaisseau"
        MiniviewLockRotationTip = "Si cette option est cochée, l'incrustation d'image pivote pour s'aligner au vaisseau affiché."
        MiniviewCombatMode
        {
            DontShow = "Ne pas montrer"
            DontShowTip = "Durant un combat, l'incrustation d'image ne sera pas affichée."
            ShowPlayer = "Voir le vaisseau du joueur"
            ShowPlayerTip = "Durant un combat, affiche toujours le vaisseaux du joueur."
            ShowEnemy = "Voir le vaisseau ennemi"
            ShowEnemyTip = "En cas de combat, affiche toujours les vaisseaux ennemis."
            Auto = "Auto"
            AutoTip = "Durant un combat, affiche le vaisseau qui n'est pas visible à l'écran."
        }
        MiniviewNonCombatMode
        {
            DontShow = "Ne pas montrer"
            DontShowTip = "Hors combat, l'incrustation d'image ne sera pas affichée."
            ShowPlayer = "Montrer le vaisseau du joueur"
            ShowPlayerTip = "Hors combat, affiche toujours le vaisseau du joueur."
            Auto = "Auto"
            AutoTip = "Hors combat, affiche le vaisseau du joueur s'il n'est pas visible à l'écran."
        }
    }

    Designer
    {
        TabName = "Concepteur"

        BuildAutoFocus = "Centrer automatiquement la vue sur le vaisseau"
        BuildAutoFocusTip = "Si cette option est cochée, l'ouverture du panneau de construction centrera automatiquement la vue sur le vaisseau sélectionné."

        BuildAutoRotate = "Aligner automatiquement au vaisseau"
        BuildAutoRotateTip = "Si cette option est cochée, l'ouverture du panneau de construction fera pivoter automatiquement la vue pour l'aligner au vaisseau sélectionné."

        BuildAutoInterior = "Vue intérieur automatique"
        BuildAutoInteriorTip = "Si cette option est cochée, l'ouverture du panneau de construction fera automatiquement apparaître l'intérieur du vaisseau."

        BuildAllowOverwrite = "Écraser les modules existantes"
        BuildAllowOverwriteTip = "Si cette option est cochée, essayer d'ajouter un module à un vaisseau remplacera les modules existants."

        GrabLeavesCorridors = "Déplacer laisse des couloirs"
        GrabLeavesCorridorsTip = "Lorsqu'un module est déplacé à l'aide de l'Outil Déplacement, des cases de couloir seront laissées à sa place."

        BuildAutoDoors = "Ajouter des portes automatiquement"
        BuildAutoDoorsTip = "Si cette option est cochée, des portes seront automatiquement créées lorsque vous ajoutez un module à un vaisseau."

        BuildEnforceCrewAccess = "Forcer l'accès de l'équipage"
        BuildEnforceCrewAccessTip = "Si cette option est cochée, vous ne pourrez pas ajouter de modules à un endroit auquel votre équipage n'a pas accès. "\
                                    "Ce réglage est sans effet si <b>Ajout automatique de portes</b> est désactivé ou lorsque vous modifiez les plans d'un vaisseau."

        AutoHireCrew = "Recrutement automatique"
        AutoHireCrewTip = "Si cette option est cochée, construire ou réparer un module qui pourvoit des lits pour l'équipage recrutera automatiquement ces membres d'équipage."

        BlueprintAutoPause = "Pause automatique lors du mode plan"
        BlueprintAutoPauseTip = "Si cette option est cochée, l'ouverture du menu des plans mettra le jeu en pause automatiquement."

        ShowInvalidBlueprints = "Afficher les plans illégaux en rouge"
        ShowInvalidBlueprintsTip = "Si coché, les plans illégaux clignoteront en rouge."

        DefaultBuildTool = "Outil par défaut"
        DefaultBuildToolTip = "L'outil à sélectionner par défaut lors de l'ouverture du panneau de construction."
        BuildGrabTool = "Outil de déplacement"
        BuildGrabToolTip = "\"L'Outil de déplacement\" sera l'outil par défaut lors de l'ouverture du panneau de construction."
        BuildSelectTool = "Outil de sélection"
        BuildSelectToolTip = "\"L'Outil de sélection\" sera l'outil par défaut lors de l'ouverture du panneau de construction."

        RowsOfParts = "Rangées de modules"
        RowsOfPartsTip = "Le nombre de lignes de modules qui seront affichées sans avoir besoin de défiler."
    }

    Painter
    {
        TabName = "Peintures"

        PaintAutoFocus = "Centrer le vaisseau automatiquement"
        PaintAutoFocusTip = "Si coché, l'ouverture du panneau de peinture centrera automatiquement la vue sur le vaisseau sélectionné."

        PaintAutoRotate = "Aligner la rotation au vaisseau automatiquement."
        PaintAutoRotateTip = "Si coché, l'ouverture du panneau de peinture alignera automatiquement la vue au vaisseau sélectionné."

        PaintAllowOverwrite = "Écraser les vignettes existantes"
        PaintAllowOverwriteTip = "Si coché, essayer d'ajouter une vignette à un endroit où une autre vignette est déjà en place écrasera la vignette existante."

        DefaultPaintTool = "Outil par défaut"
        DefaultPaintToolTip = "L'outil à sélectionner par défaut lorsque l'un des onglets 'Vignettes' du panneau de peinture est ouvert."
        PaintGrabTool = "Outil de déplacement"
        PaintGrabToolTip = "L' \"Outil de déplacement\" sera sélectionné par défaut à l'ouverture du panneau de peintures."
        PaintSelectTool = "Outil de sélection"
        PaintSelectToolTip = "L' \"Outil de sélection\" sera sélectionné par défaut à l'ouverture du panneau de peintures."
    }

    Repairs
    {
        TabName = "Réparations"

        RepairAutoFocus = "Centrer le vaisseau automatiquement"
        RepairAutoFocusTip = "Si coché, l'ouverture du panneau de réparations centrera automatiquement la vue sur le vaisseau sélectionné."

        RepairAutoRotate = "Aligner la rotation au vaisseau automatiquement."
        RepairAutoRotateTip = "Si coché, l'ouverture du panneau de réparations alignera automatiquement la vue au vaisseau sélectionné."

        RepairAutoDoors = "Reconstruction automatique des portes."
        RepairAutoDoorsTip = "Si coché, reconstruire un module détruit reconstruira automatiquement les portes connectées."
    }

    Saves
    {
        TabName = "Auto-save"

        AutoSave = "Sauvegarde automatique"
        AutoSaveTip = "Si coché, le jeu sauvegardera automatiquement la progression à intervalle régulier."
        AutoSaveEvery = "Toutes les "
        AutoSaveEveryMinutes = " minutes"
        AutoSaveEveryMinutesTip = "Intervalle en minutes entre deux sauvegardes automatiques."

        FtlAutoSave = "Sauvegarde automatique avant le saut supraluminique"
        FtlAutoSaveTip = "Si coché, la progression sera sauvegardée automatiquement avant chaque saut supraluminique."

        AutoSavesToKeep1 = "Conserve les "
        AutoSavesToKeep2 = " sauvegardes automatiques les plus récentes."
        AutoSavesToKeepTip = "Les sauvegardes auto les plus anciennes seront effacées automatiquement afin qu'il n'y en ait pas plus que ce nombre."

        QuickSavesToKeep1 = "Conserve les "
        QuickSavesToKeep2 = " sauvegardes rapides les plus récentes."
        QuickSavesToKeepTip = "Les sauvegardes rapides les plus anciennes seront effacées automatiquement afin qu'il n'y en ait pas plus que ce nombre."

        SaveLostShips = "Sauvegarde le plan de conception du vaisseau perdu"
        SaveLostShipsTip = "Si coché, les vaisseaux perdus avec un plan de conception non enregistré seront automatiquement sauvegardés dans le dossier \"Vaisseaux perdus\"."

        LostShipsToKeep1 = "Conserve les "
        LostShipsToKeep2 = " plus récents fichiers de vaisseaux perdus."
        LostShipsToKeepTip = "Les fichiers de vaisseaux perdus les plus anciens seront effacées automatiquement afin qu'il n'y en ait pas plus que ce nombre."
    }

    Multiplayer
    {
        TabName = "Multi"

        ColorMode = "Couleurs des vaisseaux"
        ColorModeTip = "Couleurs dans lesquelles les vaisseaux apparaîtront dans les parties multijoueur. Ce réglage n'affecte aucun autre joueur dans la partie."
        BlipColorMode = "Couleurs des échos radars"
        BlipColorModeTip = "Les couleurs des échos vaisseaux sur la minimap et dans le brouillard de guerre apparaîtront comme dans les parties multijoueurs. Ce réglage n'affecte aucun autre joueur dans la partie."
        RandomPerPlayer = "Couleurs aléatoire par joueur"
        RandomPerPlayerTip = "Les vaisseaux auront des couleurs aléatoires désignant le joueur qui les contrôle."
        FriendAndFoe = "Amis et ennemis"
        FriendAndFoeTip = "Les vaisseaux que vous contrôlez seront verts, les vaisseaux des autre joueurs de votre équipe seront jaunes, et les vaisseaux de l'équipe ennemie seront rouges."
        Original = "Original"
        OriginalTip = "Les vaisseaux seront colorés tels qu'ils ont été designés."

        AutoPortForwarding = "Redirection de port automatique avec UPnP"
        AutoPortForwardingTip = "Si coché, lorsque vous hébergez une partie multijoueur, Cosmoteer tentera d'utiliser la fonctionnalité \"Universal Plug and Play\" (UPnP) de votre routeur pour rediriger les ports"\
                                " nécessaires pour que les joueurs hors de votre réseau local puissent rejoindre votre partie."
        DisplayPublicIP = "Me donnez mon adresse IP publique"
        DisplayPublicIPTip = "Si coché, héberger une partie multijoueur fera apparaître l'adresse I.P. publique de votre ordinateur et la copiera dans votre presse-papier."
    }

    Colors
    {
        TabName = "Couleurs"

        Description = "Si vous rencontrez des difficultés pour différencier certaines couleurs, essayez de les changer ici pour les rendre plus faciles à distinguer."
        Friendly = "Allié"
        Enemy = "Ennemi"
        Neutral = "Neutre"
        Reset = "Par défaut"
    }

    Controls
    {
        TabName = "Racc. clavier"  // Vérifier s'il s'agit bien des raccourcis claviers. Le fichier anglais parle de contrôle sans plus de précision
        Defaults = "Restaurer les raccourcis par défaut"
        ConfirmDefaults = "Êtes-vous sûr de vouloir réinitialiser tous les raccourcis à leurs réglages par défaut ?"
    }

    Misc
    {
        TabName = "Divers"

        Language = "Langue"
        LanguageTip = "La langue utilisée pour l'interface. D'autres traductions peuvent être trouvées sur http://forum.cosmoteer.net/"

        LockCursor = "Verrouillage du curseur"
        LockCursorTip = "Si coché, le curseur ne pourra pas sortir de la fenêtre en jeu. "\
                        "Si vous jouez en Plein écran exclusif le curseur ne quittera pas la fenêtre que cette case soit cochée ou non."

        LostFocusPause = "Mettre en pause quand inactif"
        LostFocusPauseTip = "Si cette option est cochée, le jeu se mettra automatiquement en pause lorsque vous changez de fenêtre active ou cliquez en dehors du jeu. "\
                            "Cette option n'a pas d'effet en multijoueur."

        VersionCheckModeLbl = "Vérifier les mises-à-jour"
        VersionCheckModeLblTip = "Choisissez si vous souhaitez ou non rechercher des mises-à-jour au démarrage et de quel type de mises-à-jour vous souhaitez vérifier la disponibilité."
        VersionCheckMode
        {
            Off = "Désactivé"
            OffTip = "Le jeu ne cherchera pas de mises à jour."
            Stable = "Activé (Stable)"
            StableTip = "Le jeu recherchera des mises à jour, mais seulement celles qui sont relativement stables et susceptibles de comporter le moins de bugs."
            Unstable = "Activé (Instable)"
            UnstableTip = "Le jeu recherchera des mises-à-jour, y compris les plus récentes, qui n'ont pas été autant testées et sont donc susceptibles de contenir plus de bugs."
        }

        ShowNews = "Afficher les actualités non lues au démarrage"
        ShowNewsTip = "Si coché, le jeu affichera automatiquement les actualités non lues au démarrage."

        ShowAlerts = "Afficher les alertes sur l'écran titre"
        ShowAlertsTip = "Si coché, les \"alertes\" seront affichées dans le bord droit supérieur de l'écran titre."

        ShowFps = "Montrer les I.P.S. (FPS)"
        ShowFpsTip = "Choisissez si les Images Par Secondes doivent être affichées."
        FpsNone = "Désactivé"
        FpsNoneTip = "Ne pas montrer les I.P.S."
        FpsInCorner = "Activé (Dans le coin)"
        FpsInCornerTip = "Affiche les I.P.S. dans le coin supérieur gauche de l'écran."
        FpsFollowsCursor = "Activé (Près du curseur)"
        FpsFollowsCursorTip = "Affiche les I.P.S. près du curseur de la souris."

        SendMetrics = "Envoyer les statistiques de jeu et les erreurs"
        SendMetricsTip = "Si cette option est cochée, les statistiques de vos parties et les rapports d'erreurs seront envoyés au développeur et utilisées pour améliorer Cosmoteer."

        WarnOutOfDateGpuDrivers = "Avertir à propos des vieux drivers graphiques"
        WarnOutOfDateGpuDriversTip = "Si cette option est cochée, un avertissement sera affiché au lancement du jeu si vos drivers sont vieux de plus de 12 mois."

        ShowTutorials = "Montrer les Tutoriels"
        ShowTutorialsTip = "Si coché, les tutoriels \"Comment Jouer\" seront affichés pendant la partie."
        ResetTutorials = "Réinitialiser les tutoriels"
        ConfirmResetTutorials = "Cette action fera s'afficher de nouveau tous les tutoriels."
    }

    SettingsChanged = "Les réglages graphiques ont été changés, voulez-vous conserver les nouveaux réglages ?"
    KeepSettings = "Conserver"
    RevertSettings = "Restaurer"
}

Mods
{
    DialogName = "Gestionnaires de Mods"
    ModOnFmt = "{0} <good>(ACTIF)</good>"
    ModOffFmt = "{0} <bad>(INACTIF)</bad>"
    VersionFmt = "Version {0}"
    AuthorFmt = "Par {0}"
    ModLoadError = "Erreur durant le chargement du mod {0} : {1}"
    RestartInfo = "Redémarrez Cosmoteer pour que les changements de mods prennent effet."
    RestartNow = "Redémarrer Maintenant"
    RestartLater = "Redémarrer Plus Tard"
    InstallMod = "Installer le Mod…"
    OverwriteConfirm = "Un mod portant ce nom est déja installé. Voulez-vous l'écraser ?"
    ModInstalled = "Mod installé avec succès ! Vous devez l'activer pour qu'il prenne effet."
    ShowFolder = "Afficher le dossier"
    FindMods = "Trouver des mods"
    FindTranslations = "Trouver des traductions"
    UninstallMod = "Désinstaller le mod"
    UninstallConfirm = "Êtes-vous sûr de vouloir désinstaller ce mod ?"
    UninstallComplete = "Mod désinstallé avec succès."
    CreatePackage = "Créer un pack de Mods";
    CreatePackageSuccessful = "Pack de Mods sauvegardé !";
    IncompatibleWarning = "Ce mod pourrait être incompatible avec cette version de Cosmoteer et causer des erreurs. Êtes-vous sûr de vouloir l'activer ?"
    AutoDisabled = "Certains mods pourraient être incompatibles avec cette version de Cosmoteer et ont été désactivés automatiquement."
    BuiltInFolder = "Mods fournis de base"
    UserFolder = "Mods utilisateur"
    NoModsMode = "<bad>Cosmoteer est actuellement lancé en mode \"Pas de mods\", signifiant qu'ils ne seront pas chargés, même s'ils sont activés.</bad>"
}

LoadPaintScheme
{
    Title = "Charger schéma de peinture"
    Okay = "Charger"
    Delete = "Supprimer"
    ConfirmDelete = "Êtes-vous sûr de vouloir supprimer ce schéma de peinture ?"
}

Feedback
{  // TODO: Revoir le terme feedback. Peut être réutiliser le terme "Envoyer un avis / Rapporter un bug"
    Title = "Envoyer une remarque"
    Desc = "Veuillez décrire votre appréciation ou votre bug avec autant de détails que possible."
    Submit = "Soumettre votre remarque"
    Email = "Votre adresse mail (facultative) :"
    EmailTip = "Indiquer votre adresse mail nous permettra de vous répondre afin d'obtenir plus de détails sur votre avis ou votre rapport de bug."
    AttachScreenshot = "Joindre une capture d'écran"
    AttachScreenshotTip = "Prend une capture d'écran du jeu et la joint à votre message. " \
                          "La capture d'écran incluera tout ce que vous voyez actuellement sauf la fenêtre \"Envoyer une remarque\". " \
                          "Cela nous facilitera la tâche pour résoudre les bugs."
    AttachSavedGame = "Joindre la sauvegarde de la partie en cours"
    AttachSavedGameTip = "Crée une sauvegarde de la partie en cours et la joint à votre message. " \
                         "Cela nous facilitera la tâche pour résoudre les bugs."
    AttachErrorLog = "Joindre le rapport d'erreurs";
    AttachErrorLogTip = "Joint le rapport d'erreurs du programme. Cela nous facilitera la tâche pour résoudre les bugs."
    Hint = "Astuce: Vous pouvez nous envoyer un rapport à tout moment en cliquant sur le bouton <btn id='General.SubmitFeedback'/>."
    Sending = "Envoi en cours…"
    Error = "Une erreur s'est produite durant l'envoi du message."
}

VersionCheck
{
    NewVersionMsg = "Une nouvelle version de Cosmoteer est disponible!"
    DownloadInstall = "Télécharger &amp; Installer"
    ReleaseNotes = "Voir les notes de mise à jour"
    ProgressFmt = "Téléchargement de la mise à jour en cours… {0}%"
    ErrorFmt = "Erreur durant le téléchargement de la mise à jour : {0}"
    ConfirmInstall = "Le téléchargement est terminé. Fermer Cosmoteer et installer la mise à jour ?"
}

ShipLibraries
{
    Saved = "Mes Vaisseaux"
    SavedTip = "Modèles de vaisseaux que vous avez sauvegardé en vue d'un futur usage."
    Lost = "Vaisseaux perdus"
    LostTip = "Modèles de vaisseaux que vous pourriez avoir malencontreusement perdu parce qu'ils n'étaient pas sauvegardé."
    BuiltIn = "Vaisseaux livrés de base"
    BuiltInTip = "Modèles de vaisseaux livrés avec Cosmoteer."
}

ShipClasses
{
    Terran = "Terrien"
    Asteroid = "Astéroïde"
}

StarterShips
{   // La description a été réduite pour pouvoir voir toutes les informations
    ModelL = "Très manoeuvrable et livré avec trois blasters lasers pour détruire les sous-systèmes ennemis. "\
             "Mais manque de véritables défenses."
    ModelC = "Lent, bien renforcé et équipé d'une paire de canons peu précis mais pouvant pénétrer "\
             "l'intérieur des vaisseaux ennemis."
    ModelS = "Troque puissance de feu et armure contre un générateur de bouclier et un électro-rayon pouvant désactiver "\
             "armes énergétiques et boucliers."
}

BountyModeConfig
{
    Name = "Chasseur de prime"
    Description = "<b><good>Apprenez comment jouer :</good></b> Traquez les vaisseaux ennemis pour obtenir des primes et améliorer votre propre vaisseau."
    Difficulty = "Difficulté"
    MapSize = "Taille de la Galaxie"
    ShipInfoFmt = "<s24>{0}</s24>\n\n{1}\n\nFonds restants: {2}"
    CustomShipInfoFmt = "<s24>{0}</s24>\n\nFonds restants: {1}"
    LoadShip = "Charger un vaisseau personnalisé"

    Easy = "Cadet (Facile)"
    EasyTip = "La difficulté idéale pour les nouveaux joueurs:\n\n"\
              "● Crédits &amp; carburant de départ augmentés.\n"\
              "● Récompenses de primes augmentées.\n"\
              "● Vaisseaux ennemis moins intelligents.\n"\
              "● Les ennemis n'apparaîtront jamais en flottes.\n"\

    Moderate = "Capitaine (Normal)"
    ModerateTip = "Le niveau de difficulté classique pour joueurs vétérans :\n\n"\
                  "● Crédits &amp; carburant de départ normaux.\n"\
                  "● Récompenses de primes normales.\n"\
                  "● Vaisseaux ennemis normaux.\n"\
                  "● Les ennemis apparaîtront parfois en flottes.\n"\
                  "● Impossible de construire ou réparer en combat."

    Hard = "Amiral (Difficile)"
    HardTip = "Un niveau de difficulté plus élevé pour les joueurs désirant un plus grand défi :\n\n"\
              "● Crédits &amp; carburant de départ normaux.\n"\
              "● Récompenses de primes diminuées.\n"\
              "● Vaisseaux ennemis plus imposants.\n"\
              "● Les ennemis apparaîtront souvent en flottes.\n"\
              "● Impossible de construire ou réparer en combat."
}

BountyMode
{
    BountyCompleted = "CIBLE DÉTRUITE"
    BuyShipTip = "Acheter un autre vaisseau."
    SellShip = "Vendre"
    SellShipTip = "Vend ce vaisseau, vous donnant <money>₡ crédits</money> en retour."
    NoSellCombat = "Impossible de de vendre un vaisseau durant un combat."
    SellConfirmFmt = "Êtes-vous sûr de vouloir vendre le <u>{0}</u> ?"
    Sell = "VENDRE"
    NotInSight = "<bad>Doit être en vue de vos vaisseaux!</bad>"
    EnemyTooClose = "<bad>Trop près de l'ennemi !</bad>"
    BuyFuel = "Acheter"
    BuyFuelDialogFmt = "Acheter <b>{0}</b> pour {1} ?"
    FuelDebtFmt = "Ravitailler vous coûterait <ins_money>{0}</ins_money> mais vous n'avez que {1}. "\
                  "Vous pouvez vous endetter pour ravitailler, mais tant que vous serez endetté, vous ne pourrez acheter aucun module pour votre vaisseau."
    BuyShipIllegalClass = "Cette classe de vaisseau ne peut pas être achetée."
    BuyShipIllegalDesign = "Ce design de vaisseau est illégal et ne peut pas être acheté."

    MapNodeFlyOut
    {
        FriendliesFmt = "<good>Alliés présents : <b>{0}x</b></good>"
        Enemies = "Difficulté : "
        EnemiesNone = "Aucun enemi détecté"
    }

    ThreatLevels
    [
        "<color r=\"255\" g=\"255\" b=\"0\">Amateur</color>"
        "<color r=\"255\" g=\"191\" b=\"0\">Professionnel</color>"
        "<color r=\"255\" g=\"127\" b=\"0\">Vétéran</color>"
        "<color r=\"255\" g=\"63\" b=\"0\">Élite</color>"
        "<color r=\"255\" g=\"0\" b=\"0\">Avant-Garde</color>"
    ]
}

CreativeModeConfig
{
    Name = "Mode Créatif"
    Description = "Concevez des vaisseaux et des flottes avec des crédits illimités. Faites-les combattre les uns contre les autres pour tester leur efficacité."
    MapSize = "Taille de la Galaxie"
}

CreativeMode
{
    NewShip = "Nouveau vaisseau"
    ShipLibrary = "Bibliothèque de vaisseaux"

    RemoveShip = "Supprimer"
    RemoveShipTip = "Supprime le(s) vaisseau(s) sélectionné(s) de la partie.\n\nRaccourci : <btn id='CreativeMode.DeleteShip'/>\nMaintenez <btn id='General.SuppressConfirmation'/> pour supprimer la confirmation."
    ConfirmRemoveShip = "Supprimer le(s) vaisseau(s) sélectionné(s) de la partie ? Cette action ne peut pas être annulée."
    RemoveShipOkay = "Supprimer"
    IllegalShipWarning = "Ce design de vaisseau est illégal. Êtes-vous sûr de vouloir l'utliser ?"

    ClearEverything = "Tout effacer"
    ClearEverythingConfirm = "Êtes-vous sûr de vouloir retirer tous les vaisseaux de la partie ? Cette action ne peut pas être annulée."
    ClearDebris = "Effacer les débris"
    ClearDebrisConfirm = "Cette action retirera tous les vaisseaux qui n'ont pas de salle de contrôle ou d'équipage. Cette action ne peut pas être annulée."

    PartDestruct = "Auto Destruction"
    PartDestructTip = "Détruire les modules sélectionnés."
    ConfirmPartDestruct = "Détruire les modules sélectionés ? Cette action est irréversible et peut causer des dommages collatéraux !"
    PartDestructOkay = "DESTRUCTION !!"

    SavedShips
    {
        CrewCountFmt = "{0} membres d'équipage"
    }

    RandomShips
    {
        Title = "Génération procédurale de vaisseaux"
    }

    Doodads
    {
        Title = "Bidules"
        AsteroidsGroup = "Astéroïdes"
        CategoryTip = "Une catégorie. Cliquez pour développer ou réduire."
    }

    PlayAs
    {
        Title = "Jouer en tant que…"
        Tip = "Changer le joueur que vous contrôlez."
        PlayerIndexFmt = "Joueur {0}"
        PlayerIndexTipFmt = "Vous permet de contrôler les vaisseaux du joueur {0}.\n\nLes vaisseaux nouvellement placés seront donnés au joueur {0}."
        AllPlayers = "Tous les joueurs"
        AllPlayersTipFmt = "Vous permet de contrôler les vaisseaux de tous les joueurs.\n\nLes vaisseaux nouvellement placés seront donnés au joueur 1."
    }

    Ai
    {
        Title = "I.A."
        None = "Aucune"
        TipFmt = "Assigne l'I.A. '{0}' au(x) vaisseau(x) sélectionné(s)."
    }

    Allegiance
    {
        Title = "Allégeance"
        PlayerIndexFmt = "Joueur {0}"
        PlayerIndexTipFmt = "Donne l'allégeance de(s) vaisseau(x) sélectionné(s) au joueur {0}."
        Neutral = "Neutre"
        NeutralTip = "Les vaisseaux neutres sont amicaux envers tous les autres vaisseaux, sauf les barbares."
        Barbarian = "Barbares" // Pour l'instant, je laisse le terme barbare. Mais voir s'il peut être remplacer par pirate
        BarbarianTip = "Les vaisseaux \"Barbares\" sont hostiles envers tous les autres vaisseaux, y compris les autres barbares, à l'exception des vaisseaux débris."
        Junk = "Débris"
        JunkTip = "Les vaisseaux débris ne sont hostiles envers aucun autre vaisseau mais sont considérés comme sacrifiables sur la ligne de front."
    }

    BattleHelper
    {
        Title = "Assistant de Bataille"
        Player1 = "JOUEUR 1"
        Player2 = "JOUEUR 2"
        ShipFmt = " {0} ({1} {2} membres d'équipage)"
        AddShip = "Ajouter un vaisseau"
        Go = "C'EST PARTI !"
        Reset = "Redémarrer la bataille"
        ResetSwap = "Redémarrer\n+ Inverser"
        Clear = "Effacer Joueurs"
        AI = "I.A."
        InitToMax = "Démarrer avec munitions/énergie pleines."
        AutoCamera = "Caméra Automatique"
        AutoCameraLbl = "(<btn id='CreativeMode.AutoBattleCamera'/> pour basculer la caméra automatique)"
        PlayerDistance = "Distance entre joueurs : "
        ShipDistance = "Distance entre vaisseaux d'une même flotte : "
        SpawnBlocked = "There is at least one ship or piece of debris blocking the ship from spawning. Do you want to remove them?"
    }

    CameraHelper
    {
        Title = "Assistant caméra"
        StartFmt = "Début : X={0:.0}, Y={1:.0}, R={2:0}°, Z={3:.0}"
        StartNone = "Début : non défini"
        EndFmt = "Fin : X={0:.0}, Y={1:.0}, R={2:0}°, Z={3:.0}"
        EndNone = "Fin : non défini"
        Set = "Définir"
        View = "Vue" // ou voir ? je n'ai pas le contexte
        Delay = "Différer :"
        Duration = "Durée :"
        Tween = "Interpolation :" // Pas sûr de la traduction. Le contexte me fait dire qu'il s'agit de ça.
        GoWhenUnpaused = "Démarrer à la sortie de la pause"
        Start = "DÉMARRER"
        Stop = "ARRÊTER"

        TweenMode
        {
            Linear = "Linéaire"
            EaseIn = "Ease In"  // Je traduirais bien ça par exponentielle mais j'ai un énorme doute
            EaseOut = "Ease Out"
            EaseInOut = "Ease In/Out"
        }
    }
}

VersusModeConfig
{
    MaxPlayers = "Nombre de joueurs maximum"
    MaxPlayersTip = "Le nombre maximum de joueurs pouvant rejoindre la partie, incluant l'hôte."
    GameSpeed = "Vitesse de jeu"
    GameSpeedTip = "La vitesse à laquelle se déroulera la bataille. Ne peut être changée une fois la bataille lancée."
    MaxShips = "Vaisseaux par joueurs"
    MaxShipsTip = "Le nombre maximum de vaisseaux que chaque joueur peut avoir dans sa flotte."
    MaxShipValue = "Valeur maximale par vaisseau"
    MaxShipValueTip = "Le crédit (₡) maximum autorisé par vaisseau."
    ShipPreviewMode = "Aperçus des vaisseaux"
    ShipPreviewModeTip = "Détermine si les joueurs peuvent voir les vaisseaux que les autres joueurs ont choisi avant que la partie ne commence."
    TimeLimit = "Durée maximale"
    TimeLimitTip = "La durée maximale de la partie avant que l'équipe avec la plus grande force restant ne soit déclarée vainqueur."
    TimeLimitFmt = "{0} minutes"
    TimeLimitNone = "Aucune"
    VictoryCondition = "Condition de victoire"
    VictoryConditionTip = "Détermine à partir de quel point une des équipes est déclarée vainqueur."
    DestructionGoalFmt = "{0}% de destruction"
    InitToMax = "Débute avec les vaisseaux à pleine puissance de feu et de munitions"
    InitToMaxTip = "Si coché, les vaisseaux débute avec tous les systèmes pleinement chargés en puissance et munitions, prêt à la bataille. Si non coché, les vaisseaux devront produire et charger leurs munitions dès le début de la bataille."
    FogOfWar = "Brouillard de guerre"
    FogOfWarTip = "Les vaisseaux ont une ligne de vue limitée, au delà de laquelle les vaisseaux ennemis ne pourront pas être vus."
    AllowObservers = "Autoriser les observateurs"
    AllowObserversTip = "Si coché, les joueurs dans cette partie seront autorisés à observer la bataille, sans devoir choisir et commander un vaisseau."
    AllowIllegalShips = "Autoriser les vaisseaux illégaux"
    AllowIllegalShipsTip = "Si coché, les joueurs seront autorisés à utiliser des conceptions de vaisseaux qui sont autrement illégaux."

    ShipPreviewModes
    {
        Off = "Désactivé"
        Team = "Même équipe seulement"
        All = "Tout le monde"
    }
}

TeamVersusModeConfig : VersusModeConfig
{
    Name = "Équipe contre équipe"
    Description = "<b>Équipe contre équipe</b>\nDeux équipes bataillant face à face dans un terrible combat à mort !"

    Funds = "Crédits par équipe"
    FundsTip = "Le nombre total de crédits (₡) que chaque équipe est autorisée à dépenser pour constituer sa flotte."
    FleetDistance = "Distance entre les équipes"
    FleetDistanceTip = "La distance entre chaque équipe au début de la partie."
    ShareFunds = "Partage du crédit au sein de l'équipe"
    ShareFundsTip = "Si coché, les crédits de chaque joueur seront mis dans un pot commun à l'équipe."
    LockTeams = "Verouiller les équipes"
    LockTeamsTip = "Si coché, les joueurs ne seront pas autorisés à changer d'équipe. Toutefois, l'hôte est autorisé à changer un joueur d'équipe."
    PerimeterDistance = "Le Cercle de la Mort"
    PerimeterDistanceTip = "Le rayon du cercle en dehors duquel les vaisseaux prendront rapidement des dommages."
    ShrinkingPerimeter = "Resserrement du Cercle de la Mort (\"Battle Royale\")"
    ShrinkingPerimeterTip = "Si coché, le Cercle de la Mort va continuellement se resserer."

    PerimeterDistances
    {
        NearFmt = "Proche ({0} mètres)"
        NormalFmt = "Normal ({0} mètres)"
        FarFmt = "Loin ({0} mètres)"
    }

    FleetDistances
    {
        ShortFmt = "Courte ({0} mètres)"
        NormalFmt = "Normale ({0} mètres)"
        LongFmt = "Lointaine ({0} mètres)"
    }
}

FFAVersusModeConfig : VersusModeConfig
{
    Name = "Il n'en restera qu'un !"
    Description = "<b>Il n'en restera qu'un !</b>\nChaque joueur combat pour lui-même; le survivant ultime gagnera !"

    Funds = "Crédits par joueur"
    FundsTip = "Le montant total de crédits (₡) que chaque joueur peut dépenser pour sa flotte."
}

MapSizes
{
    None = "Pas de Galaxie"
    NoneTip = "Il n'y aura pas de carte de la galaxie."
    Tiny = "Minuscule"
    TinyTip = "1 système solaire."
    Small = "Petite"
    SmallTip = "3 systèmes solaires."
    Standard = "Standard"
    StandardTip = "6 systèmes solaires."
    Large = "Grande"
    LargeTip = "12 systèmes solaires."
    Huge = "Énorme"
    HugeTip = "24 systèmes solaires."
}

GameMenu
{
    NewGame = "Nouvelle partie"
    NewGameTip = "Démarrer une nouvelle partie depuis le début."
    SaveGame = "Sauvegarder la partie"
    SaveGameTip = "Sauvegarder la progression de la partie en cours dans un fichier."
    CantSaveGameTip = "La partie ne peut pas être sauvegardée pour le moment."
    LoadGame = "Charger la partie"
    LoadgameTip = "Charger une partie en cours depuis un fichier."
    Tutorials = "Comment Jouer"
    TutorialsTip = "Affiche le manuel du jeu."
    Settings = "Réglages"
    SettingsTip = "Ajuster divers réglages du jeu."
    Feedback = "Envoyer une remarque"
    FeedbackTip = "Envoyer une remarque au développeur du jeu."
    Quit = "Quitter la partie"
    QuitTip = "Quitter la partie en cours."
    Resume = "Reprendre"
    ResumeTip = "Ferme ce menu."
    ConfirmNewGame = "Démarrer une nouvelle partie ? Toute progression non sauvegardée dans la partie en cours sera perdue."
    ConfirmLoadGame = "Charger une partie sauvegardée ? Toute progression non sauvegardée dans la partie en cours sera perdue."
    ConfirmQuit = "Quitter la partie? Toute progression sera perdue."
    QuitToMenu = "Quitter vers le Menu"
    QuitToDesktop = "Quitter vers le Bureau"
}

Hud
{
    Menu = "Menu"
    MenuTip = "Mettre la partie en pause et afficher le menu.\n\nRaccourci : <btn id='General.Cancel'/>"

    MapTip = "Basculer la carte de la galaxie."

    Paused = "EN PAUSE"
    PauseTip = "Pause\n\nRaccourci : <btn id='Game.PauseToggle'/>"
    DecreaseSpeedTip = "Ralentir la vitesse du jeu\n\nRaccourci : <btn id='Game.DecreaseSpeed'/>"
    IncreaseSpeedTip = "Augmenter la vitesse du jeu\n\nRaccourci : <btn id='Game.IncreaseSpeed'/>"
    SpeedPaused = "--"
    SpeedQuarter = "¼"
    SpeedQuarterLong = "Très Lent (¼)"
    SpeedHalf = "½"
    SpeedHalfLong = "Lent (½)"
    Speed1 = "1x"
    Speed1Long = "Normal (1x)"
    Speed2 = "2x"
    Speed2Long = "Rapide (2x)"
    Speed4 = "4x"
    Speed4Long = "Très Rapide (4x)"

    ClickToFocus = "Cliquez pour centrer la vue.\n\nRaccourci : <btn id='View.FocusSelected'/>"
    ClickToSelect = "Cliquez pour sélectionner."
    ClickToRename = "Cliquez pour renommer ce vaisseau."

    SelfDestruct = "Auto-Destruction"
    SelfDestructTip = "Démarre la séquence d'auto-destruction."
    ConfirmSelfDestruct = "Détruire le(s) vaisseau(x) sélectionné(s) ? Cette action est irréversible !"
    SelfDestructOkay = "DÉTRUIRE !!"

    PartAutoFire = "Tir automatique"
    PartAutoFireTip = "Si coché, l'arme sélectionnée fera feu continuellement même si elle n'a pas de cible.\n\nRaccourci : <btn id='Game.ToggleAutoFire'/>"

    BuildTip = "<b>Construire</b>\n\nModifier le design de vos vaisseaux.\n\nRaccourci : <btn id='Design.BuildOpen'/>"
    PaintTip = "<b>Peindre</b>\n\nPeindre l'extérieur de votre vaisseau et appliquer des vignettes.\n\nRaccourci : <btn id='Design.PaintOpenClose'/>"
    RepairTip = "<b>Réparations</b>\n\nRéparer les dégâts de vos vaisseaux.\n\nRaccourci : <btn id='Repair.OpenClose'/>  (Maintenez <btn id='Repair.SuppressRepair'/> pour accéder au menu Construire.)"
    CrewTip = "<b>Équipage</b>\n\nGérer les effectifs de l'équipage de vos vaisseaux.\n\nRaccourci : <btn id='Crew.OpenClose'/>"
    InteriorTip = "Basculer l'affichage de l'intérieur du vaisseau.\n\nRaccourci : <btn id='View.ToggleInteriors'/>"
    CancelPartSelectTip = "Annuler le contrôle du module et retourner au contrôle du vaisseau.\n\nRaccourci : <btn id='General.Cancel'/>"

    MoveTip = "<b>Déplacement / Suivre</b>\n\nSe déplacer vers une position définie ou suivre un autre vaisseau.\n\nRaccourci : <btn id='Game.Move'/>"
    ForceMoveTip = "<b>Mouvement forcé</b>\n\nDéplacement sans éviter aucun obstacle.\n\nRaccourci : <btn id='Game.ForceMove'/>"
    RotateTip = "<b>Pivoter</b>\n\nPivoter le vaisseau.\n\nRaccourci : <btn id='Game.Rotate'/>"
    StrafeTip = "<b>Translater</b>\n\nSe déplacer sans tourner.\n\nRaccourci : <btn id='Game.Strafe'/>"
    AttackTip = "<b>Attaque</b>\n\nAttaquer un autre vaisseau, qu'il soit ennemi ou un des vôtres.\n\nRaccourci : <btn id='Game.Attack'/>"
    FormationTip = "<b>Formations</b>\n\nVos vaisseaux dans la flotte se mettent en formation."
    HaltTip = "<b>Stopper</b>\n\nAnnuler tous les autres ordres.\n\nRaccourci : <btn id='Game.Halt'/>"

    TargetTip = "<b>Ciblage des armes</b>\n\nVise avec les armes sélectionnées, qu'il soit ennemi ou un des vôtres.\n\nRaccourci : <btn id='Game.TargetWeapon'/>"
    CancelTargetTip = "Annuler le ciblage des armes.\n\nRaccourci : <btn id='Game.CancelWeaponTargets'/>"

    MoneyTip = "Crédits Intergalactiques "
    FtlFuelTip = "Carburant pour saut supraluminique"

    FtlGuiTitle = "Activation du moteur de saut supraluminique…"
    FtlStatusPercentFmt = "{0:0}%"
    FtlStatusReady = "<good>PRÊT</good>"
    FtlStatusCanceled = "<bad><s12>RESTANT</s12></bad>"
    FtlStatusNoFtl = "<bad>PAS DE SAUT SUPRALUMINIQUE</bad>"
    FtlDoJumpFmt = "SAUTER<s6>\n\n</s6>{0}"
    FtlDoJumpTip = "Tous les vaisseaux qui sont <good>PRÊTS</good> vont sauter vers le secteur de destination.\n\nRaccourci : <btn id='Game.DoFtlJump'/>"
    FtlCancelJump = "Annuler"
    FtlCancelJumpTip = "Tous les vaisseaux vont éteindre leur moteur supraluminique et le saut sera annulé.\n\nRaccourci : <btn id='Game.CancelFtlJump'/>"
    FtlShipsNotReady = "Tous les vaisseaux ne sont pas prêts pour le saut supraluminique. Sauter quand même et laisser ces vaisseaux sur place ?"

    SelectSingleShip = "Sélectionnez un seul vaisseau."
    SelectShip = "Sélectionnez au moins un vaisseau."
    SelectMultipleShips = "Sélectionnez au moins deux vaisseaux."
    NoCommandsToCancel = "Aucune commande à annuler."
    NoTargetsToCancel = "Aucune ciblage à annuler pour l'armement."
    CantBuildNeedsRepair = "Impossible de construire lorsque votre vaisseau a besoin de réparations majeures."
    CantBuildInCombat = "Impossible de construire durant un combat."
    NoRepairsNeeded = "Aucune réparation nécessaire."
    CantRepairInCombat = "Impossible de réparer durant un combat."

    ShipWeightFmt = "Masse : <b>{0:.0} tonnes</b>"
    ShipWeightTip = "Masse totale du vaisseau, indiquant sa taille approximative."
    ShipCrewFmt = "Équipage : <b>{0} âmes</b>"
    ShipCrewTip = "Nombre de membres d'équipage vivants à bord de ce vaisseau."
    ShipValueFmt = "Valeur : <money><b>{0}</b></money>"
    ShipValueTip = "Valeur monétaire totale de ce vaisseau, telle que calculée selon son prix de construction et le recrutement de son équipage moins les réparations nécessaires."
    NoControlRoomAlert = "<bad>PAS DE SALLE DE CONTRÔLE</bad>"
    ControlRoomNotOperationalAlert = "<bad>SALLE DE CONTRÔLE\nNON OPÉRATIONNELLE</bad>"

    RenameShip = "Renommer le vaisseau"
    RenameShipTip = "Changez le nom de votre vaisseau !"
    RenameShipPrompt = "\"Comment devrions-nous le baptiser, cap'taine ?\"" // Pensez à mettre des guillemets françaises

    SaveShip = "Sauvegarder le design du vaisseau" // Toujours du mal avec le mot design, qui se rapproche d'une conception graphique en français
    SaveShipTip = "Sauvegarder les plans et les peintures du vaisseau dans un fichier pour pouvoir les charger plus tard."

    Screenshot = "Capture d'écran"
    ScreenshotExterior = "Extérieure"
    ScreenshotExteriorTip = "Prendre une capture d'écran de l'extérieur du vaisseau et la sauvegarder dans un fichier."
    ScreenshotExteriorFilenameFmt = "{0} (Exterior).png"
    ScreenshotInterior = "Intérieure"
    ScreenshotInteriorTip = "Prendre une capture d'écran du pont intérieur du vaisseau et la sauvegarder dans un fichier."
    ScreenshotInteriorFilenameFmt = "{0} (Interior).png"
    ScreenshotBlueprints = "Plans"
    ScreenshotBlueprintsTip = "Prendre une capture d'écran des plans du vaisseau et les sauvegarder dans un fichier."
    ScreenshotBlueprintsFilenameFmt = "{0} (Blueprints).png"

    DistFmt = "{0:0.00}km"

    DebtOkay = "S'endetter"

    MiniviewResizerTip = "Glisser pour redimensionner."

    UnknownContact = "Contact Inconnu"

    FlightDirection = "Direction de vol"

    FormationOrder = "Ordre de formation"
    FormationOrderFmt = "#{0}"

    ResetDefaults = "Restaurer les valeurs d'attaque par défaut"
    ResetDefaultsTip = "Lorsque vous définissez manuellement la distance ou l'angle d'attaque, ils seront mémorisés la prochaine fois que vous donnerez un ordre d'attaque. "\
                       "Cette option réinitialisera la distance et l'angle d'attaque à leurs valeurs par défaut."

    PartHealthFmt = "{0} / {1}"

    DisplayShips = "Affichage"
    DisplaySelectedShips = "Du vaisseau sélectionné uniquement"
    DisplayAllShips = "De tous les vaisseaux"
}

Formations
{
    Line = "Formation en ligne"
    Wedge = "Formation en chevron"
    Claw = "Formation en pince"

    A = "A"  // Il y a un alphabet radio français, mais il n'est pas utilisé par l'armée. Dommage car je trouvais ça rigolo.
    Alpha = "Formation Alpha"  // Anatole
    B = "B"
    Bravo = "Formation Bravo"  // Berthe
    C = "C"
    Charlie = "Formation Charlie"  // Célestine
    D = "D"
    Delta = "Formation Delta"  // Désiré
    E = "E"
    Echo = "Formation Echo"  // Eugène
    F = "F"
    Foxtrot = "Formation Foxtrot"  // François
    G = "G"
    Gamma = "Formation Golf"  // Gaston

    NameFmt = "<b>{0}</b>"
    NameHotkeyTipFmt = "<b>{0}</b>\n\nRaccourci : <b>{1}</b>"
    Save = "SAUVEGARDER"
    SaveTip = "Sauvegarder une formation personnalisée dans ce slot."
    Delete = "SUPPR"
    DeleteTip = "Supprime la formation personnalisée sauvegardée dans ce slot."
    CustomFormationsTip = "Formations Personnalisées"
    CancelTip = "Annuler la formation actuelle."
}

BuildBox
{
    Undo = " Annuler "
    UndoTip = "Annule le dernier changement apporté au vaisseau sélectionné.\n\nRaccourci : <btn id='Design.Undo'/>"
    Redo = " Rétablir "
    RedoTip = "Rétablit le dernier changement apporté au vaisseau sélectionné.\n\nRaccourci : <btn id='Design.Redo'/>"
    EditBlueprintsTip = "<b>Mode Plans</b>\n\nVous permet d'apporter des changements temporairement invalides ou inabordables au design de votre vaisseau.\n\n"\
                        "Raccourci : <btn id='Design.ToggleBlueprints'/>"
    InsufficientFunds = "FONDS INSUFFISANTS"
    Power = "Énergie"
    Crew = "Équipage"
    FtlEfficiency = "Efficacité du moteur de saut supraluminique"
    StatBarTipFmtMinIdeal = "<s20><b>{0}</b></s20>\n<bad>Minimum : <b>{1}</b></bad>\n<good>Recommandé : <b>{2}</b></good>"
    StatBarTipFmt = "<s20><b>{0}</b></s20>"
    TotalValueFmt = "Valeur totale du vaisseau :\n{0}"
    Construct = "FAIRE COMME ÇA"
    Discard = "Abandonner les modifications"
    DiscardTip = "Abandonne toutes les modifications faites aux plans du vaisseau qui n'ont pas encore été appliquées."
    CantDiscardTip = "Rien à abandonner."
    Clear = "Effacer les plans"
    ClearTip = "Efface tous les plans existants pour que vous puissiez les redessiner depuis le début."
    CantClearTip = "Rien à effacer."
    ClearInvalid = "Supprimer les modules invalides."
    ClearInvalidTip = "Supprimes tous les modules invalides (clignotant en rouge) des plans."
    CantClearInvalidTip = "No invalid parts to remove."
    Recenter = "Recentrer les plans"
    RecenterTip = "Déplace les plans du vaisseau au milieu de la grille de construction."
    CantRecenterTip = "Les plans sont déjà centrés."
    SaveShip = "Sauvegarder le design du vaisseau"
    SaveShipTip = "Sauvegarder les plans et les peintures du vaisseau dans un fichier pour pouvoir les charger plus tard."
    LoadShip = "Charger le design du vaisseau"
    LoadShipTip = "Remplace les plans actuels par ceux chargés depuis un fichier précédemment sauvegardé."
    ImportPng = "Charger la forme depuis un PNG"
    ImportPngTip = "Charge la forme basique du vaisseau en cases de couloirs depuis un fichier PNG personnalisé."
    ImportPngInstructions = "Ceci remplacera les plans actuels (si il y en a) par une forme basique chargée depuis un fichier PNG personnalisé.\n\n"\
                            "● <b>Intensité</b> : les pixels intenses (rouge, vert, ou bleu supérieur à 50%) seront interprétés comme des cases couloir.\n\n"\
                            "● <b>Opacité</b> : les pixels avec une opacité supérieure à 50% seront interprétés comme des cases couloir."
    ImportPngBrightness = "Utiliser l'<b>intensité</b>"
    ImportPngOpacity = "Utiliser l'<b>opacité</b>"
    ImportPngFileType = "Fichiers image PNG(*.png)"
    ImportPngSizeWarningFmt = "Ce fichier image est plus grand que la taille de vaisseau maximum de {0}x{1} et va être rogné."
    GrabTip = "<b>Outil de saisie</b>\n\nLorsque sélectionné, cliquer sur un module le saisira et le gardera en main pour que vous puissiez le replacer ailleurs.\n\nRaccourci : <btn id='Design.GrabTool'/>"
    RemoveTip = "<b>Outil de suppression</b>\n\nLorsque sélectionné, cliquer sur un module le supprimera et vous remboursera partiellement.\n\nRaccourci : <btn id='Design.EraseTool'/>\n\nMaintenez <btn id='Design.E raseCursorMode'/> pour basculer temporairement sur cet outil."
    SelectTip = "<b>Outil de sélection</b>\n\nLorsque sélectionné, tracez une zone autour de tout module que vous voulez copier, couper, coller, doubler, pivoter ou enlever.\n\nRaccourci : <btn id='Design.SelectionTool'/>"\
                "\nMaintenez <btn id='Design.ContiguousSelectionMode'/> pour la sélection contigue par \"baguette magique\"."
    MirrorToggleTip = "<b>Mode Miroir</b>\n\nLorsque ce mode est activé, les changements au design seront projetés à l'opposé de la ligne centrale du vaisseau.\n\nRaccourci : <btn id='Design.ToggleMirrorMode'/>"
    ResetMirrorLines = "Réinitialiser les lignes du mode miroir."
    ResetMirrorLinesTip = "Réinitialiser au centre du vaisseau les lignes horizontales et verticales du mode miroir."
    BrushTip = "Modifiez la forme ou la taille de la brosse à utiliser pour placer le module ou l'outil sélectionné."
    BrushDisabledTip = "Le module ou l'outil sélectionné ne prend pas en charge les brosses de formes et de tailles."
    HireCrewTip = "Recruter des membres d'équipage pour remplir les lits vides. Si vous avez plus de membres d'équipage que de lits, les membres d'équipage en trop seront tous virés."
    NumCrewTip = "Nombre de membres d'équipage à recruter." // J'ai bien envi de renommer en moussaillon :D
    UncomittedModifications = "Les plans de ce vaisseau comportent des modifications non appliquées. Êtes-vous sûr de vouloir les abandonner ?"
    DiscardModifications = "Abandonner les modifications"
    MustRepair = "Ce vaisseau a subi des dégâts et certains modules doivent être réparés avant de pouvoir le modifier."
    MustRepairContinue = "Ce vaisseau a subi des dégâts et certains modules doivent être réparés avant de pouvoir continuer."
    Repair = "RÉPARER"
    CantModifyInCombat = "Impossible de modifier ce vaisseau durant un combat."
    CantUndoInCombat = "Impossible d'annuler durant un combat."
    CantRedoInCombat = "Impossible de rétablir durant un combat."
    NothingToUndo = "Rien à annuler."
    NothingToRedo = "Rien à rétablir."
    NoWorkNeeded = "AUCUNE MODIFICATION NÉCESSAIRE"
    NoWorkNeededTip = "Il n'y a aucune modification à faire !"
    BlueprintsInvalidTip = "Les plans de ce vaisseau sont invalides !"
    CantBuildInCombatTip = "Impossible de construire durant un combat !"
    FireCrewFmt = " Virer {0} membres d'équipages : {1}"
    HireCrewFmt = " Recruter {0} membres d'équipages: {1}"
    ConfirmClose = "Fermer l'interface de construction avant que votre vaisseau ne soit construit vous fera perdre vos plans. Êtes-vous sûr de vouloir fermer l'interface de construction ? "\
                   "(Cliquez sur le bouton <b>Faire Comme Ça</b> pour construire un vaisseau d'après votre plan.)"
    FlightDirectionTip = "<b>Direction de vol</b>\n\nLa direction dans laquelle le vaisseau volera lorsqu'il voyagera sur de longues distances."
    ConstructionBlocked = "La construction est bloquée par un autre vaisseau."

    RotateLeftTip = "Pivoter dans le sens anti-horaire.\n\nRaccourci : <btn id='Design.RotateLeft'/>"
    RotateRightTip = "Pivoter dans le sens horaire.\n\nRaccourci : <btn id='Design.RotateRight'/>"
    FlipXTip = "Retourner horizontalement.\n\nRaccourci : <btn id='Design.FlipX'/>"
    FlipYTip = "Retourner verticalement.\n\nRaccourci : <btn id='Design.FlipY'/>"
    CantRotateTip = "Le module sélectionné ne peut pas être pivoté."
    DeletePartTip = "Supprime le module saisi.\n\nRaccourci : <btn id='Design.Delete'/>"

    CopyTip = "Copier les modules sélectionnés.\n\nRaccourci : <btn id='Design.CopySelected'/>"
    CutTip = "Couper les modules sélectionnés.\n\nRaccourci : <btn id='Design.CutSelected'/>"
    DeleteTip = "Supprimer les modules sélectionnés.\n\nRaccourci : <btn id='Design.Delete'/> (ou <btn id='Design.DeleteDoors'/> pour supprimer seulement les portes)"
    PasteTip = "Coller les modules sélectionnés.\n\nRaccourci : <btn id='Design.Paste'/>"
    CancelPasteTip = "Annuler et retourner au mode de sélection.\n\nRaccourci : <btn id='General.Cancel'/>"
    NoPartsSelected = "Aucun module sélectionné."
    NoPartsCopied = "Aucun module copié pour l'instant."
    CantRemoveSelected = "Les modules sélectionnés ne peuvent pas être retirés."
    SelectedValueFmt = "Sélection : <money>{0}</money>"

    PartCrewFmt = "{0} membres d'équipage"
    PartToHireCrewFmt = " + <money>{0}</money> pour recruter {1} membres d'équipage"
    PartHotkeyFmt = "Raccourci : <b>{0}</b>"
    BrushHotkeyFmt = "Raccourci : <b>{0}</b>"

    BuffPercentageFmt = "<good>+{0:0}%</good>"

    InvalidReasons
    {
        NotContiguous = "<bad>Non connecté</bad>"
        ProhibitedZones = "<bad>Zone interdite</bad>"
        MaxBordersExceeded = "<bad>En dehors de la grille</bad>"
        CategorySlotsExceeded = "<bad>Trop de modules de ce type</bad>"
        ExistingPart = "<bad>Module existant</bad>"
        NoCrewAccess = "<bad>Aucun accès pour l'équipage</bad>"
        Blocked = "<bad>Construction bloquée</bad>"
        NotAllowed = "<bad>Non autorisé</bad>"
    }
}

PaintBox
{
    PaintTab = "PEINDRE"
    Decals1Tab = "VIGNETTES BAS"
    Decals2Tab = "VIGNETTES HAUT"
    CrewTab = "ÉQUIPAGE"

    Undo = " Annuler "
    UndoTip = "Annule le dernier changement fait à la peinture du vaisseau sélectionné.\n\nRaccourci : <btn id='Design.Undo'/>"
    Redo = " Rétablir "
    RedoTip = "Rétablis le dernier changement fait à la peinture du vaisseau sélectionné.\n\nRaccourci : <btn id='Design.Redo'/>"
    NothingToUndo = "Rien à annuler."
    NothingToRedo = "Rien à rétablir."

    Clear = "Effacer"
    ClearAll = "Toutes les vignettes"
    ClearAllTip = "Efface toutes les vignettes pour que vous puissiez recommencer à peindre depuis le début."
    Clear1 = "Vignettes Bas"
    Clear1Tip = "Efface toutes les vignettes dans \"Vignettes Bas\" pour que vous puissiez recommencer à peindre depuis le début."
    Clear2 = "Vignettes Haut"
    Clear2Tip = "Efface toutes les vignettes dans \"Vignettes Haut\" pour que vous puissiez recommencer à peindre depuis le début."
    NothingToClear = "Rien à effacer."

    Swap = "Inverser"
    SwapDecals = "Vignettes Seulement"
    SwapDecalsTip = "Inverse les vignettes dans \"Vignettes Bas\" et \"Vignettes Haut\" mais pas les couleurs."
    SwapColors = "Couleurs Seulement"
    SwapColorsTip = "Inverse les couleurs dans \"Vignettes Bas\" et \"Vignettes Haut\" mais pas les vignettes."
    SwapBoth = "Vignettes & Couleurs"
    SwapBothTip = "Inverse les couleurs et les vignettes dans \"Vignettes Bas\" et \"Vignettes Haut\"."
    NothingToSwap = "Rien à inverser."

    SaveShip = "Sauvegarder le design du vaisseau"
    SaveShipTip = "Sauvegarde les plans et les couleurs du vaisseau dans un fichier pour pouvoir les charger plus tard."
    LoadPaint = "Charger le design du vaisseau"
    LoadPaintTip = "Remplace les peintures actuelles du vaisseau par celles chargées depuis un fichier sauvegardé précédemment."
    SavePaintScheme = "Sauvegarder le schéma de peinture"
    SavePaintSchemeTip = "Sauvegarde les motifs et les couleurs de la peinture du vaisseau pour pouvoir les réutiliser sur d'autres vaisseaux."
    LoadPaintScheme = "Charger le schéma de peinture"
    LoadPaintSchemeTip = "Remplace le schéma de peinture actuel avec un schéma de peinture sauvegardé précédement."
    PaintSchemeSaved = "Schéma de peinture sauvegardé."

    GrabTip = "<b>Outil de saisie</b>\n\nLorsque sélectionné, cliquer sur une vignette la saisira et la gardera en main pour que vous puissiez la placer ailleurs.\n\nRaccourci : <btn id='Design.GrabTool'/>"
    RemoveTip = "<b>Outil de suppression</b>\n\nLorsque sélectionné, cliquer sur une vignette la supprimera.\n\nRaccourci : <btn id='Design.EraseTool'/>\n\nMaintenez <btn id='Design.EraseCursorMode'/> pour passer temporairement à cet outil."
    SelectTip = "<b>Outil de sélection</b>\n\nLorsque sélectionné, sélectionnez une zone autour de toutes les vignettes que vous voulez copier, couper, coller, projeter, pivoter ou supprimer.\n\nRaccourci : <btn id='Design.SelectionTool'/>"\
                "\nMaintenez <btn id='Design.ContiguousSelectionMode'/> pour la sélection contigue par \"baguette magique\"."
    MirrorToggleTip = "<b>Mode Miroir</b>\n\nLorsque cette option est activée, les changements aux vignettes du vaisseau seront projetés à l'oppposé de la ligne centrale du vaisseau.\n\nRaccourci: <btn id='Design.ToggleMirrorMode'/>"
    ResetMirrorLines = "Réinitialiser les lignes du mode miroir."
    ResetMirrorLinesTip = "Réinitialiser au centre du vaisseau les lignes horizontales et verticales du mode miroir."
    BrushTip = "Modifiez la forme ou la taille de la brosse à utiliser pour placer le module ou l'outil sélectionné."
    BrushDisabledTip = "Le module ou l'outil sélectionné ne prend pas en charge les brosses de formes et de tailles."

    RotateLeftTip = "Pivoter dans le sens anti-horaire.\n\nRaccourci : <btn id='Design.RotateLeft'/>"
    RotateRightTip = "Pivoter dans le sens horaire.\n\nRaccourci : <btn id='Design.RotateRight'/>"
    FlipXTip = "Retourner horizontalement.\n\nRaccourci : <btn id='Design.FlipX'/>"
    FlipYTip = "Retourner verticalement.\n\nRaccourci : <btn id='Design.FlipY'/>"
    DeleteDecalTip = "Supprime la vignette tenue.\n\nRaccourci : <btn id='Design.Delete'/>"

    CopyTip = "Copier les vignettes sélectionnées.\n\nRaccourci : <btn id='Design.CopySelected'/>"
    CutTip = "Couper (copier et retirer) les vignettes sélectionnées.\n\nRaccourci : <btn id='Design.CutSelected'/>"
    DeleteTip = "Effacer les vignettes sélectionnées.\n\nRaccourci : <btn id='Design.Delete'/>"
    PasteTip = "Coller les vignettes sélectionnées.\n\nRaccourci : <btn id='Design.Paste'/>"
    CancelPasteTip = "Annuler et retourner au mode sélection.\n\nRaccourci : <btn id='General.Cancel'/>"
    NoDecalsSelected = "Aucune vignette sélectionnée."
    NoDecalsCopied = "Aucune vignette copiée pour l'instant."
}

MirrorAxis
{
    Vertical = "Miroir : axe vertical"
    Horizontal = "Miroir : Axe horizontal"
    Both = "Miroir : tous les deux"
}

Brushes
{
    Block1x1 = "Bloc 1x1"
    Block1x1Icon = "1x1"
    Block2x2 = "Bloc 2x2"
    Block2x2Icon = "2x2"
    Block3x3 = "Bloc 3x3"
    Block3x3Icon = "3x3"
    Block4x4 = "Bloc 4x4"
    Block4x4Icon = "4x4"
    Block5x5 = "Bloc 5x5"
    Block5x5Icon = "5x5"
    Block6x6 = "Bloc 6x6"
    Block6x6Icon = "6x6"
    Block7x7 = "Bloc 7x7"
    Block7x7Icon = "7x7"
    Block8x8 = "Bloc 8x8"
    Block8x8Icon = "8x8"
    Block9x9 = "Bloc 9x9"
    Block9x9Icon = "9x9"
    Block10x10 = "Bloc 10x10"
    Block10x10Icon = "10x10"

    Line = "Ligne"
    LineIcon = "Ligne"
    LineTip = "Maintenez <btn id='Design.RestrictShapeMode'/> pour faire une ligne droite."

    Box = "Rectangle"
    BoxIcon = "Rectangle"
    BoxTip = "Maintenez <btn id='Design.RestrictShapeMode'/> pour faire un carré."

    Oval = "Ovale"
    OvalIcon = "Ovale"
    OvalTip = "Maintenez <btn id='Design.RestrictShapeMode'/> pour faire un cercle."

    Triangle = "Triangle"
    TriangleIcon = "Triangle"
    TriangleTip = "Maintenez <btn id='Design.RestrictShapeMode'/> pour faire un triangle isocèle."

    Fill = "Remplissage"
    FillIcon = "Remplissage"
}

RepairBox
{
    Title = "Réparations"

    RepairAll = "TOUT RÉPARER"
    NoRepairsNeeded = "AUCUNE RÉPARATION\nNÉCESSAIRE"
    NoRepairsNeededTip = "Il n'y a aucune réparation nécessaire !"
    CantRepairInCombatTip = "Impossible de réparer durant un combat !"
    CantRepairInCombatCursor = "<bad>IMPOSSIBLE DE RÉPARER\nDURANT UN COMBAT</bad>"

    HireCrewFmt = "Recruter {0} membres d'équipage : {1}"
    HireCrewTip = "Recruter des membres d'équipage pour remplacer ceux morts au combat."
    NumCrewTip = "Nombre de membres d'équipage à recruter."

    ForgetDestroyed = "Oublier les modules détruits"
    ForgetDestroyedTip = "Oublie tous les modules qui ont été détruits mais pas encore reconstruits."
    NothingToForget = "Rien à oublier."
    ConfirmForgetDestroyed = "Êtes-vous sûr de vouloir oublier tous les modules détruits? "\
                             "Cette action est irréversible et effacera également votre historique d'annulation !"

    PartsDestroyedFmt = "Modules détruits : {0}"
    PartsDamagedFmt = "Modules endommagés : {0}"
    CrewKilledFmt = "Équipage mort au combat : {0}"

    RepairDebtFmt = "Réparer votre vaisseau coûterait <ins_money>{0}</ins_money> mais vous n'avez que {1}. "\
                    "Vous pouvez vous endetter pour réparer, mais tant que vous serez endetté vous ne pourrez acheter aucun nouveau module pour votre vaisseau."
}

CrewBox
{
    Title = "Équipage"
    Crew = "ÉQUIPAGE"
    Beds = "LITS"
    NumCrewTip = "Nombre actuel de membres d'équipage du vaisseau."
    MaxCrewTip = "Nombre maximum de membres d'équipage que ce vaisseau peut transporter."
    AddOne = "+1"
    AddFmt = "+{0}"
    AddOneTip = "Recruter 1 membre d'équipage.\n\nMaintenez <btn id='Crew.FiveAtATime'/> pour en recruter 5."
    AddMax = "+MAX"
    AddMaxTip = "Recruter autant de membres d'équipage que possible."
    RemoveOne = "-1"
    RemoveFmt = "-{0}"
    RemoveOneTip = "Virer 1 membre d'équipage.\n\nMaintenez <btn id='Crew.FiveAtATime'/> pour en virer 5."
    CantHireInCombat = "Impossible de recruter ou virer des membres d'équipage durant un combat !"
    Full = "PLEIN"
    ResetCrewPositions = "Réinitialiser la position de l'équipage"
    ResetCrewPositionsTip = "Réaffecter tous les membres d'équipage à leurs quartiers."
}

ColorPicker
{
    Copy = "Copier Couleur"
    Paste = "Coller Couleur"
}

BillOfSale
{
    RepairsFmt = "Réparations mineures : {0}"
    ConstructionExpenses = "<u>Dépenses de construction :</u>"
    DeconstructionRefunds = "<u>Remboursement de déconstructions :</u>"
    ItemCostFmt = "  {0}x <b>{1}</b> @ {2} = <money>{3}</money>"
    ItemRefundFmt = "  {0}x <b>{1}</b> @ {2} = <refund>{3}</refund>"
    HireCrewFmt = "Recruter {0}x <b>membres d'équipage</b> @ {1} = <money>{2}</money>"
    FireCrewFmt = "Virer {0}x <b>membres d'équipage</b> @ {1} = <refund>{2} REMBOURSEMENT</refund>"
    ExpensesSubtotalFmt = "Sous-total des dépenses : <money>{0}</money>"
    RefundsSubtotalFmt = "Sous-total des remboursements : <refund>{0}</refund>"
    TotalCostFmt = "<b>COÜT TOTAL : <money>{0}</money></b>"
    TotalRefundFmt = "<b>REMBOURSEMENT TOTAL : <refund>{0}</refund></b>"
}

FuelCostBreakdown
{
    FuelForShipFmt = "{0} ({1:0}%) = {2}"
    TotalFuelUsedFmt = "<b>TOTAL DE CARBURANT UTILISÉ : {0}</b>"
}

EditorGroups
{
    Weapons = "Armes"
    Munitions = "Munitions"
    Defenses = "Défenses"
    Flight = "Navigation"
    Crew = "Équipage"
    Power = "Énergie"
    Misc = "Divers"
}

CategoryNouns
{
    ThrusterSingular = "Propulseur"
    ThrusterPlural = "Propulseurs"
}

Parts
{
    // Terran

    AmmoFactory = "Usine d'obus"
    AmmoFactoryIcon = "Usine d'obus"
    AmmoFactoryDesc = "Fabrique des obus pour canon."

    AmmoStorage = "Dépôt d'obus"
    AmmoStorageIcon = "Dépôt d'obus"
    AmmoStorageDesc = "Entrepose une quantité limitée d'obus, fabriqués séparément par une usine d'obus."

    Armor = "Blindage"  // Je n'aimais pas le terme "Armure" d'origine
    ArmorIcon = &Armor
    ArmorDesc = "Absorbe une grande partie des tirs ennemis, protégeant les entrailles du vaisseau."

    Armor1x2WedgeL = "Blindage en coin 1x2 (gauche)"
    Armor1x2WedgeLIcon = "Blindage en coin 1x2 (G)"
    Armor1x2WedgeLDesc = &ArmorDesc

    Armor1x2WedgeR = "Blindage en coin 1x2 (droite)"
    Armor1x2WedgeRIcon = "Armor 1x2 Wedge (D)"
    Armor1x2WedgeRDesc = &ArmorDesc

    Armor2x1 = "Blindage 2x1"
    Armor2x1Icon = &Armor2x1
    Armor2x1Desc = &ArmorDesc

    ArmorTri = "Blindage en triangle"
    ArmorTriIcon = &ArmorTri
    ArmorTriDesc = &ArmorDesc

    ArmorWedge = "Blindage en coin" // Pour wedge, j'hésite entre coin, join, calle, angle
    ArmorWedgeIcon = &ArmorWedge
    ArmorWedgeDesc = &ArmorDesc

    CannonLarge = "Grand canon"
    CannonLargeIcon = &CannonLarge
    CannonLargeDesc = "Fusionne 4 obus pour augmenter grandement la force de pénétration et les dégâts par rapport au canon standard."

    CannonMed = "Canon standard"
    CannonMedIcon = &CannonMed
    CannonMedDesc = "Tire un obus à la fois, perçant les vaisseaux ennemis et y causant parfois des incendies."

    ControlRoomSmall = "Passerelle (commandement)" // aussi la timonerie
    ControlRoomSmallIcon = &ControlRoomSmall
    ControlRoomSmallDesc = "Un vaisseau sans passerelle (aussi appellé timonerie) ne peut voler ou coordonner ses tirs."

    Conveyor = "Tapis roulant"
    ConveyorIcon = &Conveyor
    ConveyorDesc = "Permet à l'équipage de se déplacer plus vite, mais dans une seule direction."

    Corridor = "Coursive"
    CorridorIcon = &Corridor
    CorridorDesc = "Une coursive à travers laquelle l'équipage peut se déplacer rapidement."

    CrewQuartersMed = "Poste d'équipage"  // Quartier désigne autre chose
    CrewQuartersMedIcon = &CrewQuartersMed
    CrewQuartersMedDesc = "Pourvoit des lits pour 6 membres d'équipage."

    CrewQuartersSmall = "Cabine d'équipage"
    CrewQuartersSmallIcon = "Cabine"
    CrewQuartersSmallDesc = "Pourvoit des lits pour 2 membres d'équipage."

    Door = "Porte" // Écoutille ne se rapporte que pour les portes menant vers l'extérieur
    DoorIcon = &Door
    DoorDesc = "ermet à l'équipage (et au feu !) de se déplacer d'une pièce à l'autre."

    ElectroBolter = "Bolter électrique"  // plutôt qu'Électro-Rayon, le bolter semblant être un truc spécifique à warhammer
    ElectroBolterIcon = &ElectroBolter
    ElectroBolterDesc = "Tire des rayons d'énergie électrique qui font peu de dégâts mais peuvent court-circuiter les systèmes ennemis, les privant d'énergie. Peut pénétrer les boucliers dont il aspire l'énergie."

    EngineRoom = "Salle des machines"  // Plutôt appelé compartiment machine par les marins
    EngineRoomIcon = &EngineRoom
    EngineRoomDesc = "Augmente la puissance des propulseurs adjacent de 75%."

    ExplosiveCharge = "Charge explosive"
    ExplosiveChargeIcon = &ExplosiveCharge
    ExplosiveChargeDesc = "Un petit engin explosif pouvant être déclenché manuellement. Principalement utilisé pour diviser délibérément les vaisseaux en plusieurs morceaux."

    FireExtinguisher = "Extincteur"
    FireExtinguisherIcon = &FireExtinguisher
    FireExtinguisherDesc = "Contient un extincteur que l'équipage peut utiliser pour éteindre les incendies."

    FtlDrive = "Moteur à saut supraluminique"
    FtlDriveIcon = &FtlDrive
    FtlDriveDesc = "Autorise le vaisseau à sauter vers un autre endroit de la galaxie, en utilisant les technologies exploitant l'Hyperespace."

    IonBeamEmitter = "Émetteur à faisceau ionique"
    IonBeamEmitterIcon = "Faisceau ionique"
    IonBeamEmitterDesc = "Tire un puissant rayon d'énergie dans une direction fixe."

    LaserBlasterSmall = "Blaster laser"
    LaserBlasterSmallIcon = &LaserBlasterSmall
    LaserBlasterSmallDesc = "Une arme très précise et polyvalent tirant des décharges d'énergie, causant des dégâts modérés aux vaisseaux ennemis."

    LaserBlasterLarge = "Blaster lourd laser"
    LaserBlasterLargeIcon = &LaserBlasterLarge
    LaserBlasterLargeDesc = "Assemble deux gros canons lasers sur une seule tourelle, se traduisant par des dommages bien plus important au détriment de la précision et la polyvalence."

    MissileFactory = "Usine de missile"
    MissileFactoryIcon = &MissileFactory
    MissileFactoryDesc = "Fabrique des missiles utilisés par les lance-missiles."

    MissileLauncher = "lance-missile"
    MissileLauncherIcon = &MissileLauncher
    MissileLauncherDesc = "Tire des missiles guidés à longue portée infligeant des dégâts sur une large zone."

    MissileStorage = "Dépôt de missile"
    MissileStorageIcon = &MissileStorage
    MissileStorageDesc = "Entrepose une quantité limitée de missiles, qui sont fabriqués séparément par une usine de missiles."

    PointDefense = "Système de défense anti-missile"
    PointDefenseIcon = "Défense anti-missile"
    PointDefenseDesc = "Un système défensif automatisé qui abat les missiles ennemis en utilisant des cartouches de plasma surchauffé. Inefficace contre les vaisseaux."

    PowerStorage = "Dépôt d'énergie" // Pas fan de la traduction, mais traduit bien l'utilité
    PowerStorageIcon = "Dépôt"
    PowerStorageDesc = "Entrepose une quantité limitée de piles à plasma, pouvant être utilisé pour alimenter les systèmes environnants."

    RailgunLauncher = "Module de lancement pour canon électrique" // ou canon à rail
    RailgunLauncherIcon = "Lanceur pour canon électrique"
    RailgunLauncherDesc = "Composant essentiel pour les canons électriques. À associer avec un chargeur et éventuellement à des accélérateurs.\n\n"\
                        "Les canons électriques tirent des projectiles accélérés par une force électromagnétique, qui peuvent pénétrer profondément les vaisseaux ennemis, causant d'importants dommages."
                        // Il y avait une ligne ici, mais elle était redondante avec la première ligne

    RailgunLoader = "Module de chargement pour canon électrique"
    RailgunLoaderIcon = "Chargeur pour canon électrique"  // Chargeur en français se réfère plutôt au magasin d'une arme
    RailgunLoaderDesc = "Composant essentiel pour les canons électriques. À associer avec un lanceur et éventuellement à des accélérateurs.\n\n"\
                        "Les canons électriques tirent des projectiles accélérés par une force électromagnétique, qui peuvent pénétrer profondément les vaisseaux ennemis, causant d'importants dommages."
                         // Il y avait une ligne ici, mais elle était redondante avec la première ligne

    RailgunAccelerator = "Module d'accélérateur pour canon électrique"
    RailgunAcceleratorIcon = "Accélérateur pour canon électrique"
    RailgunAcceleratorDesc = "Composant facultatif à placer entre le lanceur et le chargeur du canon électrique. Chaque accélérateur augmente la vélocité des projectiles, augmentant ainsi les dommages et la force de pénétration.\n\n"\
                        "Les canons électriques tirent des projectiles accélérés par une force électromagnétique, qui peuvent pénétrer profondément les vaisseaux ennemis, causant d'importants dommages."
                         // Il y avait une ligne ici, mais elle était redondante avec la première ligne

    ReactorSmall = "Cœur de réacteur"
    ReactorSmallIcon = "Réacteur"
    ReactorSmallDesc = "Produit continuellement les piles à plasma utilisées pour alimenter la plupart des systèmes du vaisseau."

    SensorArray = "Réseau de capteurs"
    SensorArrayIcon = "Capteurs"
    SensorArrayDesc = "Augmente la portée des capteurs de votre vaisseau."

    ShieldGenSmall = "Générateur de bouclier"
    ShieldGenSmallIcon = &ShieldGenSmall
    ShieldGenSmallDesc = "Projette un bouclier d'énergie défensif en arc-de-cercle à l'extérieur du vaisseau, bloquant la plupart des tirs entrants."

    Structure = "Armature"
    StructureIcon = &Structure
    StructureDesc = "L'armature sous-jacente qui maintient le vaisseau. L'armature est inclue automatiquement avec toutes les pièces et couloirs."

    Structure1x2WedgeL = "Armature en coin 1x2 (gauche)"  // Même problématique que le blindage en coin
    Structure1x2WedgeLIcon = "Armature en coin 1x2 (G)"
    Structure1x2WedgeLDesc = &StructureDesc

    Structure1x2WedgeR = "Armature en coin 1x2 (droite)"
    Structure1x2WedgeRIcon = "Armature en coin 1x2 (D)"
    Structure1x2WedgeRDesc = &StructureDesc

    StructureWedge = "Armature en coin"
    StructureWedgeIcon = &StructureWedge
    StructureWedgeDesc = &StructureDesc

    ThrusterBoost = "Propulsion magnéto-plasmique à impulsion spécifique variable"  // https://fr.wikipedia.org/wiki/Propulsion_magn%C3%A9to-plasmique_%C3%A0_impulsion_sp%C3%A9cifique_variable
    ThrusterBoostIcon = "Propulsion magnéto-plasmique"
    ThrusterBoostDesc = "Variante du grand propulseur, pouvant injecter du plasma brut directement dans la chambre à combustion, pour une accélération puissante et éphémère."

    ThrusterHuge = "Immense propulseur"  // Pour les propulseurs, plutôt utiliser des classes types Mark IV ou autre
    ThrusterHugeIcon = &ThrusterHuge
    ThrusterHugeDesc = "Un immense moteur capable de propulser le vaisseau avec plus de deux fois de force qu'un grand propulseur. A besoin d'un long temps d'accélération pour être à pleine pousée."  // J'ai un doute. Est-ce une accélération soudaine ou une accélération progressive ?

    ThrusterLarge = "Grand propulseur"
    ThrusterLargeIcon = &ThrusterLarge
    ThrusterLargeDesc = "Un moteur deux fois plus gros capable de propulser le vaisseau avec plus de deux fois de force qu'un propulseur standard. A besoin d'un temps moyen d'accélération pour être à pleine poussée"

    ThrusterMed = "Propulseur standard"
    ThrusterMedIcon = &ThrusterMed
    ThrusterMedDesc = "Un moteur de taille standard capable de propulser le vaisseau avec une force modeste. A besoin d'un court temps d'accélération pour être à pleine poussée"

    ThrusterSmall = "Petit propulseur"
    ThrusterSmallIcon = &ThrusterSmall
    ThrusterSmallDesc = "Un petit moteur utilisé principalement pour manœuvrer."

    ThrusterSmall2Way = "Petit propulseur bi-directionel"
    ThrusterSmall2WayIcon = &ThrusterSmall2Way
    ThrusterSmall2WayDesc = "Un petit moteur à deux directions utilisé principalement pour manœuvrer."

    ThrusterSmall3Way = "Petit propulseur tri-directionel"
    ThrusterSmall3WayIcon = &ThrusterSmall3Way
    ThrusterSmall3WayDesc = "Un petit moteur à trois directions utilisé principalement pour manœuvrer."

    WallHole = "Trou"
    WallHoleDesc = "Un trou percé à travers la coque"

    // Asteroid

    Rubble1 = "Décombres 1"
    Rubble2 = "Décombres 2"
}

PartTriggers
{
    Detonate = "Déclencher la charge explosive\n\nRaccourci : <btn id='PartTriggers.detonate'/>"
}

PartToggles
{
    OnOff_Off = "<b>Alim. : <bad>éteint</bad></b>\n\nRaccourci : <btn id='PartToggles.on_off'/>"
    OnOff_On = "<b>Alim. : <good>allumé</good></b>\n\nRaccourci : <btn id='PartToggles.on_off'/>"
    FireMode_Hold = "<b>Tir : en attente</b>\nNe tire que si une cible est désignée.\n\nRaccourci : <btn id='PartToggles.fire_mode'/>"
    FireMode_AtWill = "<b>Tir : feu à volonté</b>\nTire sur toutes les cibles ennemies à portée.\n\nRaccourci : <btn id='PartToggles.fire_mode'/>"
    Fire_Synchronized = "<b>Tir : synchronisé</b>\n\nRaccourci : <btn id='PartToggles.fire_alternating'/>"
    Fire_Alternating = "<b>Tir : en alternance</b>\n\nRaccourci : <btn id='PartToggles.fire_alternating'/>"
    Boost_Off = "<b>Booster : éteint</b>\n\nRaccourci : <btn id='PartToggles.thruster_boost'/>"
    Boost_On = "<b>Booster : allumé</b>\n\nRaccourci : <btn id='PartToggles.thruster_boost'/>"
}

GalaxyMap
{
    PlanetInfoFmt = "Classe : <b>{0}</b>\nMasse : <b>{1}</b>\nDistance : <b><ftl>{2}</ftl></b>"
    CurPlanetInfoFmt = "Classe : <b>{0}</b>\nMasse : <b>{1}</b>"
    ViewSector = "Voir le secteur"
    ViewSectorNotSaveable = "Vous ne pouvez pas voir un autre secteur tant que le jeu est dans un état non sauvegardable."
    PlotCourseFmt = "Enclencher le saut supraluminique\n{0}"
    PlotCourseNoFtl = "Saut supraluminique Non Disponible"
    PlotCourseNoFtlTip = "Aucun de vos vaisseaux ne dispose du moteur de saut supraluminique et d'une paserelle de commandement. Il vous faut impérativement ces deux modules pour effectuer un saut supraluminique."
    PlotCourseNoFuel = "Il vous faut plus de carburant dans le moteur de saut supraluminique avant de pouvoir sauter."
    PlotCourseOnlySelectedMsg = "Voulez enclencher le moteur de saut supraluminique sur <b>tous</b> vos vaisseaux ou seulement ceux <b>sélectionnés</b>?"
    PlotCourseAllShipsFmt = "Tous les vaisseaux\n{0}"
    PlotCourseSelectedShipsFmt = "Sélectionnés Uniquement\n{0}"
    PlotCourseNoneSelected = "Aucun vaisseau n'a été sélectionné!"
    CancelCourseFmt = "Annuler le saut supraluminique\n{0}"
    CurrentLocation = "POSITION ACTUELLE"
}

Planets
{
    Alien = "Exotique"
    Barren = "Stérile"
    Gas = "Géante Gazeuse"
    Lava = "Volcanique"
    Rocky = "Rocheuse"
    Sun = "Étoile"
    Terra = "Terrienne"
}

AI
{
    Easy = "I.A. Facile"
    Normal = "I.A. Normal"
}

Tutorials
{
    Okay = "J'ai compris!"
    HowToPlay = "Comment jouer:"
    HowToPlayDialog = "Comment jouer"

    Ammo1
    {
        Title = "Vaisseaux: Canons & Missiles"
        Cannon = "Les <yellow>Canons</yellow> et les <yellow>Lance-Missile</yellow> sont des armes à projectiles utilisant des <yellow>munitions</yellow> et des <yellow>missiles</yellow> au lieu d'énergie."
        Factory = "Les munitions sont fabriquées par une <yellow>Usine à Munitions</yellow>, et les missiles sont fabriqués par une <yellow>Usine à Missiles</yellow>."
        Crew = "Votre <yellow>équipage</yellow> transportera les munitions et les missiles de vos usines à vos canons et lance-missiles."
        Tip = "<green><b>ASTUCE:</b></green> La fréquence à laquelle un canon ou un lance-missile peut tirer dépend de la vitesse à laquelle votre équipage peut lui apporter des munitions ou des missiles."
    }

    Blueprints1
    {
        Title = "Design de vaisseau avancé"
        MirrorMode = "Activer le <yellow>mode miroir</yellow> pour créer rapidement des designs de vaisseau symétriques."
        SelectCopyPaste = "Utilisez l'<yellow>outil sélection</yellow> pour copier, coller, projeter, pivoter ou effacer des sections entières de votre vaisseau."
        Button = "Pour modifier les <blue>plans</blue> de votre vaisseau, cliquez sur le bouton <b>Activer le Mode Plans</b>."
        Ship = "Utilisez les plans pour apporter temporairement des changemnts à votre vaisseau qui seraient autrement illégaux, et pour expérimenter avant de dépenser des crédits <green>₡</green>."
        Commit = "Lorsque vous êtes satisfait de votre design, cliquez sur le bouton <b>FAIRE COMME ÇA</b>. Votre vaisseau sera modifié et le prix sera déduit de vos crédits <green>₡</green>."
    }

    Build1
    {
        Title = "Améliorer votre vaisseau"
        Button = "Pour <yellow>améliorer votre vaisseau</yellow>, cliquez sur le bouton <b>Construire</b> en bas à gauche."
        Parts = "Pour <yellow>ajouter un module</yellow> à votre vaisseau, <b>sélectionnez-le</b> dans le menu ci-dessous. Puis <b>cliquez</b> là où vous voulez l'ajouter sur votre vaisseau."
        Rotate = "Pour <yellow>pivoter un module</yellow> avant de l'ajouter, utilisez les boutons de rotation ou <b>le clic droit</b>."
        Tip = "<green><b>ASTUCE:</b></green> Vous ne pouvez pas améliorer votre vaisseau lorsque vous êtes sous le feu ennemi!"
    }

    Build2
    {
        Title = "Améliorer votre vaisseau (Suite)"
        Grab = "Pour <yellow>saisir un module</yellow> et le déplacer ailleurs, utilisez l'outil <b>Déplacement</b>."
        Delete = "Pour <yellow>retirer un module</yellow> de votre vaisseau, utlisez l'outil <b>Suppression</b>. Vous serez remboursé à 75%."
        Tip = "<green><b>ASTUCE:</b></green> Vous avez fait une erreur ? Cliquez simplement sur le bouton <b>Annuler</b> ou appuyez sur <btn id='Design.Undo'/>."
        Close = "Lorsque vous avez <yellow>terminé</yellow> d'améliorer votre vaisseau, appuyez de nouveau sur <b>Construire</b> ou <btn id='General.Cancel'/> pour sortir du mode Construction."
    }

    CameraControls1
    {
        Title = "Contrôler la Caméra"
        EdgePan = "Pour <yellow>déplacer la caméra</yellow>, déplacez le <b>curseur de la souris</b> vers le bord de l'écran ou appuyez sur les <b>flèches directionnelles ou les touches WASD</b>."
        Zoom = "Pour <yellow>zoomer en avant ou en arrière</yellow>, utilisez la <b>molette</b> de votre souris ou les touches <btn id='View.ZoomIn'/> et <btn id='View.ZoomOut'/>."
        Tip = "<green><b>ASTUCE:</b></green> Vous ne trouvez pas votre vaisseau? Cliquez sur son icône dans le coin supérieur gauche ou appuyez sur la touche <btn id='View.FocusSelected'/> (Centrer)."
    }

    CameraControls2
    {
        Title = "Contrôler la Caméra (Avancé)"
        Drag = "Pour <yellow>glisser la caméra</yellow>, cliquez, maintenez, puis glissez le <b>bouton central de la souris</b>."
        FocusClick = "Pour <yellow>centrer la caméra</yellow> sur un vaisseau, cliquez dessus avec le <b>bouton central de la souris</b>.\n\nVous pouvez aussi utiliser le <b>bouton central de la souris</b> à un endroit vide pour centrer la caméra dessus."
        AltDrag = "Pour <yellow>centrer sur plusieurs</yellow>, maintenez la touche <btn id='View.FocusCursorMode'/>, puis <b>avec le clic gauche</b> sélectionnez une zone autour de ces vaisseaux."
        Tip = "<green><b>ASTUCE:</b></green> Appuyez sur la touche <btn id='View.FocusSelected'/> pour centrer la caméra sur votre vaisseau."
    }

    Minimap1
    {
        Title = "La Mini-Carte"
        BasicInfo = "La <yellow>mini-carte</yellow> dans le coin inférieur droit affivhe l'emplacement des vaisseaux dans la zone."
        ShipDots = "L'emplacement de votre vaisseau est indiqué par le <green>point vert</green>.\n\nL'emplacement des vaisseaux ennemis est indiqué par les <red>points rouges</red>."
        LeftClick = "<b>Cliquez</b> sur la mini-carte pour déplacer la caméra à cet endroit."
    }

    Combat1
    {
        Title = "Attaquer l'Ennemi"
        Blips = "Les vaisseaux ennemis qui sont trop loin pour que vous puissiez les voir directement sont indiqués par des <red>échos radar</red> clignotants."
        Attack = "Pour <yellow>attaquer un vaisseau ennemi</yellow>, <b>faites un clic droit</b> sur le vaisseau ennemi ou sur son écho radar.\n\nVotre vaisseau se dirigera automatiquement vers lui et l'attaquera."
        Tip = "<green><b>ASTUCE:</b></green> Certains vaisseaux ennemis seront trop puissants pour que vous puissiez les vaincre! Fuyez et <yellow>améliorez</yellow> votre vaisseau avant de les attaquer."
    }

    CreativeMode1
    {
        Title = "Mode Créatif"
        Unlimited = "Le mode créatif vous permet de créer et combattre des vaisseaux avec des crédits <green>₡</green> virtuellement illimités."
        NewShip = "Pour <yellow>concevoir un nouveau vaisseau</yellow> depuis le début, cliquez sur le bouton <b>Nouveau Vaisseau</b>."
        SaveShip = "Pour <yellow>sauvegarder</yellow> votre design de vaisseau, cliquez sur le bouton <img name='hamburger'/> sur le panneau de construction puis sélectionnez <b>Sauvegarder le Design de vaisseau</b>."
        AddShip = "Pour <yellow>ajouter un vaisseau sauvegardé</yellow> à la partie, cliquez sur le bouton <b>Galerie de Vaisseaux</b>."
        Allegiance = "Pour <yellow>faire combattre les vaisseaux</yellow>, cliquez qur le petit bouton <img name='hamburger'/> à côté du nom du vaisseau, sélectionnez <b>Allégeance</b>, puis choisissez un joueur différent pour chaque vaisseau. "\
                     "Les vaisseaux assignés à des joueurs différents peuvent recevoir l'ordre de s'attaquer entre eux et feront feu automatiquement une fois à portée."
        PlayAs = "Pour changer de quel joueur vous pouvez <yellow>contrôler</yellow> les vaisseaux, cliquez sur le bouton <img name='hamburger'/> en haut et sélectionnez <b>Jour en tant que...</b>."
    }

    Crew1
    {
        Title = "Vaisseaux: Équipage"
        InteriorButton = "Pour <yellow>voir l'intérieur</yellow> de votre vaisseau, cliquez sur le bouton <b>Afficher/cacher l'intérieur</b>."
        Crew = "<yellow>L'Équipage</yellow> fait fonctionner votre vaisseau en contrôlant les armes, en pilotant, et en transportant l'approvisionnement. Plus un vaisseau a d'équipage, plus il peut fonctionner efficacement!"
        Indicator = "Un module qui n'a aucun membre d'équipage pour le faire fonctionner aura un <red>icône rouge</red>."
    }

    Crew2
    {
        Title = "Vaisseaux: Équipage (Suite)"
        Button = "Pour faire de la place pour <yellow>plus de membres d'équipage</yellow>, cliquez de nouveau sur le bouton <b>Construire</b>."
        Quarters = "Ajoutez des <yellow>Couchettes d'équipage</yellow> ou des <yellow>Quartiers d'équipage</yellow> pour augmenter le nombre de membres d'équipage à bord du vaisseau. Vous n'en aurez jamais trop!"
        Door = "Ajoutez des <yellow>portes</yellow> à votre vaisseau pour que l'équipage puisse circuler entre les pièces."
        Meter = "La <b>Jauge d'équipage</b> suggère le nombre <bad>minimum</bad> et <good>recommandé</good> de membres d'équipage pour votre vaisseau."
    }

    Micro1
    {
        Title = "Microgestion de votre vaisseau"
        Select = "Avec un vaisseau sélectionné, <b>cliquez</b> sur l'un de ses modules pour le<yellow>sélectionner</yellow>.\n\nVous pouvez aussi sélectionner une zone autour de plusieurs modules ou double-cliquer pour sélectionner tous les modules du même type."
        Power = "Appuyez sur le bouton <b>Alimentation</b> pour <yellow>l'éteindre</yellow>. Tout membre d'équipage opérant ce module le quittera et ira aider ailleurs."
        HoldFire = "Appuyez sur le bouton <b>Mode de Tir</b> pour ordonner à une arme de <yellow>ne pas tirer</yellow> tant que vous ne lui avez pas donné une cible précise."
        Target = "Avec une arme sélectionnée, <b>faites un clic-droit</b> sur un module ennemi pour le <yellow>cibler</yellow> uniquement avec cette arme."
    }

    Movement1
    {
        Title = "Piloter Votre Vaisseau"
        Move = "Pour <yellow>piloter votre vaisseau</yellow>, <b>faites un clic-droit</b> n'importe où dans l'espace. Votre vaisseau s'y dirigera automatiquement."
    }

    Movement2
    {
        Title = "Piloter Votre Vaisseau (Avancé)"
        Drag = "Pour <yellow>ajuster l'orientation</yellow> de votre vaisseau, <b>faites un clic-droit</b> puis <b>glissez</b>."
        Queue = "Pour <yellow>ajouter des points de passage</yellow>, maintenez <btn id='Game.AppendSelection'/> en cliquant droit."
        Handles = "Pour <yellow>déplacer ou pivoter</yellow> des points de passage existants, maintenez <btn id='Game.AppendSelection'/> puis glissez l'un des icônes qui apparaît.\n\nPour <yellow>supprimer</yellow> un point de passage, faites un <b>clic-droit</b> sur l'un de ces icônes."
    }

    Multiship1
    {
        Title = "Agrandir votre Flotte"
        BuyShip = "Pour <yellow>agrandir votre flotte</yellow>, cliquez sur le bouton <b>Acheter un vaisseau</b> au-dessus de la mini-carte."
        Selected = "Lorsque vous avez plusieurs vaisseaux, <b>cliquez</b> sur le vaisseau que vous voulez <yellow>contrôler</yellow>.\n\nLe vaisseau contrôlé a un <green>cercle vert </green> autour de lui."
        BoxSelect = "Pour <yellow>contrôler plusieurs vaisseaux</yellow> à la fois, <b>cliquez et tracez</b> une zone autour de ces vaisseaux.\n\nOu alors, maintenez <btn id='Game.AppendSelection'/> puis <b>cliquez</b> sur chaque vaisseau."
    }

    Formations1
    {
        Title = "Formations"
        BasicFormations = "Pour ordonner à vos vaisseaux de <yellow>voler en formation</yellow>, sélectionnez au moins deux vaisseaux, cliquez sur le bouton <b>Formations</b>, puis choisissez la formation à utiliser."
        CustomFormations = "Pour créer une <yellow>formation personnalisée</yellow>, sélectionnez un vaisseau puis placez-le près d'un autre vaisseau en faisant un <b>clic-droit</b> sur un autre vaisseau, puis en maintenant le bouton droit de la souris et en <b>glissant depuis ce vaisseau</b>."
        SavingFormations = "Pour <yellow>sauvegarder une formation personnalisée</yellow>, cliquez sur la petite flèche puis sur l'un des boutons <b>SAUVEGARDER</b> pour sauvegarder le formation dans un emplacement de formation personnalisée."
    }

    Paint1
    {
        Title = "Peindre votre vaisseau"
        Button = "Pour <yellow>peindre l'extérieur de votre vaisseau</yellow>, cliquez sur le bouton <b>Peindre</b> en bas à gauche."
        ColorWheel = "Ici vous pouvez changer la <yellow>couleur de base</yellow> ainsi que le <yellow>motif</yellow> de votre vaisseau."
        Decals = "Vous pouvez aussi peindre des <yellow>vignettes</yellow> sur votre vaisseau.\n\nUn vaisseau peut avoir jusqu'à deux couches de vignettes. Chaque couche peut avoir une couleur différente, et toutes les vignettes de cette couche partagent cette couleur."
        Tip = "<green><b>ASTUCE:</b></green> Peindre votre vaisseau est gratuit et n'a aucun effet sur ses capacités."
    }

    Power1
    {
        Title = "Vaisseaux: Énergie"
        Reactor = "Les <yellow>Réacteurs</yellow> génèrent les batteries à plasma utilisées par vos propulseurs, vos armes énergétiques, et d'autres modules."
        Crew = "Votre <yellow>équipage</yellow> transportera les piles à plasma depuis le <b>Réacteur</b> ou le <b>Dépôt d'énergie</b> jusqu'aux modules de votre vaisseau."
        Meter = "La <b>Jauge d'Énergie</b> suggère les niveaux d'énergie <bad>minimum</bad> et <good>recommandés</good> pour votre vaisseau."
        Indicator = "Un module qui n'a pas assez d'énergie pour opérer aura un <red>icône rouge</red>."
        Tip = "<green><b>ASTUCE:</b></green> La fréquence à laquelle une arme énergétique peut tirer dépend de la vitesse à laquelle l'équipage peut l'alimenter en énergie."
    }

    Repairs1
    {
        Title = "Réparer votre vaisseau"
        Button = "Lorsque votre vaisseau a besoin de réparations, un bouton <b>Réparer</b> rouge apparaîtra en haut à gauche. Cliquez dessus pour <yellow>ouvrir le mode réparation</yellow>."
        Parts = "Pour <yellow>réparer un module</yellow> qui est endommagé ou détruit, <b>cliquez</b> dessus."
        RepairAll = "Ou alors, pour<yellow>réparer votre vaisseau entier</yellow>, cliquez sur le bouton <b>Tout Réparer</b>."
    }

    Tactics1
    {
        Title = "Tactiques de Combat"
        Target = "Après avoir attaqué un ennemi, faites un <b>clic-droit</b> de nouveau sur un module particulier du vaisseau ennemi pour le <yellow>cibler</yellow> avec vos armes."
        Reactor = "<green><b>ASTUCE:</b></green> Détruisez le <yellow>réacteur</yellow> du vaisseau ennemi pour le transformer en coque sans vie!\n\n"
    }

    Tactics2
    {
        Title = "Tactiques de Combat (Avancé)"
        Drag = "Pour choisir une <yellow>distance</yellow> et une <yellow>direction</yellow> d'attaque, faites un <b>clic-droit</b> sur le vaisseau ennemi, maintenez et <b>glissez</b> depuis votre cible."
        Handles = "Pour ajuster la <yellow>distance</yellow>, la <yellow>direction</yellow>, ou <yellow>l'orientation</yellow> après avoir attaqué, maintenez <btn id='Game.AppendSelection'/> puis glissez l'un des icônes qui apparaissent."
        TargetQueue = "Pour <yellow>mettre en attente des cibles additionnelles</yellow>, maintenez <btn id='Game.AppendSelection'/> puis faites un clic-droit sur les modules."
    }

    Thrusters1
    {
        Title = "Vaisseaux: Propulseurs"
        Thruster = "Ajoutez des <yellow>propulseurs</yellow> pour augmenter la vitesse et la manoeuvrabilité de votre vaisseau. Un vaisseau avec trop peu de propulseurs ne peut pas voler."
        Many = "Les propulseurs propulsent votre vaisseau dans la direction opposée.\n\nLa vitesse et la manoeuvrabilité de votre vaisseau dépendent du nombre, de la position, de l'orientation et de la taille de ses propulseurs."
        Tip = "<green><b>ASTUCE:</b></green> Un vaisseau rapide et manoeuvrable possède plusieurs propulseurs à des endroits et des orientations différents."
    }

    Time1
    {
        Title = "Contrôler le Temps"
        Buttons = "Pour <yellow>mettre la partie en pause</yellow> à tout moment, cliquez sur le bouton <b>||</b> dans le coin supérieur gauche ou appuyez sur la touche <btn id='Game.PauseToggle'/>."
        Faster = "Pour <yellow>accélérer</yellow> ou <yellow>décélérer</yellow> le temps, cliquez sur les boutons <b>&gt;&gt;</b> ou <b>&lt;&lt;</b>."
        Tip = "<green><b>ASTUCE:</b></green> Si jamais vous avez des difficultés à cliquer sur quelque chose parce que ça bouge trop vite, appuyez simplement sur <btn id='Game.PauseToggle'/> pour mettre la partie en pause."
    }

    Ftl1
    {
        Title = "Hyperpropulsion"
        NoEnemies = "Une fois tous les vaisseaux ennemis vaincus, il est temps de <yellow>voyager</yellow> vers un autre <yellow>secteur</yellow>!\n"
        BuildFtl = "Construisez un <yellow>Moteur à Hyperpropulsion</yellow> pour pouvoir effectuer un <yellow>Saut Hyperpropulsé</yellow>."
        Efficiency = "Un grand vaisseau requiert plusieurs moteurs à hyperpropulsion répartis à son bord afin d'économiser du <fuel>CARBURANT</fuel>. "\
                     "Les vaisseaux avec une jauge d'<yellow>Éfficacité de l'hyperpropulsion</yellow> consommeront moins de carburant que d'autres vaisseaux de même taille."
        Map = "Pour enclencher un saut, ouvrez la <b>Carte de la Galaxie</b> en cliquant sur le bouton au-dessus de la mini-carte ou en appuyant sur la touche <btn id='Game.ToggleMap'/>."
    }

    Ftl2
    {
        Title = "Hyperpropulsion (Suite)"
        ViewNode = "Cliquez sur un <yellow>secteur</yellow> avoisinant afficher des informations le concernant. Chaque secteur a des ennemis de difficulté différente.\n\nChoisissez une destination puis cliquez sur le bouton <b>Enclencher l'Hyperpropulsion</b>."
        PlotCourse = "Votre équipage allumera automatiquement les moteurs à hyperpropulsion de votre vaisseau.\n\nUne fois alimentés à <ftl>100%</ftl>, cliquez sur <b>SAUTER</b> ou appuyez sur la touche <btn id='Game.DoFtlJump'/>."
        Fuel = "<green><b>ASTUCE:</b></green> La quantité de <fuel>CARBURANT</fuel> utilisée dépend de la distance parcourue, de la taille de votre vaisseau, et de l'efficacité de ses moteurs à hyperpropulsion."
    }

    Fire1
    {
        Title = "Incendies"
        Cause = "Des <red>Incendies</red> peuvent se déclarer lorsque vous êtes touché par certaines armes et lorsque des modules inflammables explosent. Si ils ne sont pas maîtrisés, "\
                "les incendies se répandront rapidement, causant des dommages et tuant l'équipage."
        FireExtinguisher = "Ajoutez des <yellow>extincteurs</yellow> à votre vaisseau pour aider à combattre les incendies. Votre équipage va prendre "\
                           "les extincteurs et les utiliser pour éteindre les incendies."
        Spread = "<green><b>ASTUCE:</b></green> Les incendies peuvent se répandre à travers les pièces ouvertes et les portes, mais pas à travers les murs. "\
                 "Ajouter beaucoup de portes à votre vaisseau le rendra plus vulnérable aux incendies."
    }
}
